человек	м.
дело	ср.
день	м.
том	м.
друг	м.
сердце	ср.
руки	мн. разг.
жизнь	ж.
бог	м.
слова	мн.
свои	мн. разг.
моя	ж. разг.
та	ж. разг.
господин	м.
деньги	мн.
обломов	м. разг.
ночь	ж.
брат	м.
отец	м.
мои	мн. разг.
дверь	ж.
ваше	ср. разг.
мысль	ж.
господа	мн.
дела	мн. разг.
час	м.
письмо	ср.
дом	м.
любовь	ж.
место	ср.
генерал	м.
голос	м.
глаз	м.
старик	м.
дядюшка	м. разг.
места	мн.
дядя	м.
вопрос	м.
года	мн.
мысли	мн. разг.
той	м.
вечер	м.
другое	ср. разг.
взгляд	м.
год	м.
женщина	ж.
начала	мн.
батюшка	м.
целый	прил.
разговор	м.
случай	м.
народ	м.
сударь	м.
вздор	м.
наши	мн. разг.
мгновение	ср.
платье	ср.
последний	прил.
нос	м.
тысячи	мн.
ум	м.
ваши	мн. разг.
душа	ж.
превосходительство	ср.
сон	м.
мальчик	м.
дочь	ж.
чувства	мн.
силы	мн.
чувство	ср.
ваша	ж. разг.
утро	ср.
губы	мн.
капитан	м.
сын	м.
доктор	м.
волосы	мн.
последнее	ср.
грудь	ж.
часть	ж.
дети	мн.
старуха	ж.
герой	м.
хлестаков	м. разг.
конец	м.
добрый	прил.
кровь	ж.
многие	мн.
хозяйка	ж.
барин	м.
ответ	м.
дух	м.
окно	ср.
воды	мн.
сударыня	ж.
дама	ж.
некоторые	мн.
государь	м.
твоя	ж. разг.
наше	ср. разг.
городничий	м.
голубчик	м.
пан	м.
граф	м.
путь	м.
небо	ср.
дитя	ср.
подлец	м. разг.-сниж.
твердо	ср.
новый	прил.
радость	ж.
вещи	мн.
сад	м.
постой	м.
твои	мн. разг.
домна	ж.
девушка	ж.
рука	ж.
полковник	м.
здоровье	ср.
дали	мн.
девочка	ж.
миг	м.
внимание	ср.
впечатление	ср.
положение	ср.
права	мн.
век	м.
выражение	ср.
крик	м.
хозяин	м.
первое	ср.
бедная	ж. разг.
лошади	мн.
вера	ж.
стены	мн.
долг	м.
постель	ж.
пот	м.
сапоги	мн.
история	ж.
ворота	мн.
ветер	м.
дедушка	м.
огонь	м.
вещь	ж.
грех	м.
боль	ж.
море	ср.
церковь	ж.
милая	ж. разг.
дед	м.
гость	м.
бумаги	мн.
офицер	м.
платок	м.
прав	прил.
пути	мн.
тело	ср.
молчание	ср.
новое	ср. разг.
вина	ж.
полчаса	м.
ангел	м.
первые	мн.
карман	м.
вино	ср.
лес	м.
обед	м.
шаг	м.
хлеб	м.
глупости	мн. разг.
старец	м.
желание	ср.
движение	ср.
душ	м.
многое	ср.
рада	ж. местн.
суд	м.
волнения	мн.
плечо	ср.
толпа	ж.
ма	ж. нескл. разг.-сниж.
мамаша	ж. разг.
толь	м.
общество	ср.
солдат	м.
знак	м.
тол	м.
сестра	ж.
возможности	мн.
мечты	мн.
старая	ж. разг.
дождь	м.
дорога	ж.
песни	мн. разг.
улыбка	ж.
согласен	прил.
удовольствие	ср.
хорош	прил. разг.
белые	мн.
горы	мн.
рассказ	м.
снег	м.
генеральша	ж. разг.
память	ж.
кофе	м. нескл.
мнение	ср.
надежда	ж.
очередь	ж.
ком	м.
мадам	ж. нескл.
стихи	мн.
ухо	ср.
болезнь	ж.
обстоятельства	мн.
цель	ж.
комната	ж.
черта	ж.
камень	м.
предмет	м.
берет	м.
уши	мн. разг.
начало	ср.
всякое	ср. разг.
па	ср. нескл.
старушка	ж. разг.
карты	мн.
ро	ср. нескл.
прокурор	м.
работы	мн.
кот	м.
страшный	прил.
высокий	прил.
лука	ж.
годы	мн.
кум	м.
половина	ж.
черты	мн.
неправда	ж.
русские	мн.
собаки	мн.
графа	ж.
молодые	мн.
барышня	ж.
продолжение	ср.
стакан	м.
красавица	ж.
помещик	м.
вода	ж.
перо	ср.
слуга	м.
четверть	ж.
дыхание	ср.
портрет	м.
большое	ср. разг.
вор	м.
мама	ж.
план	м.
шаги	мн.
як	м.
жив	прил.
удар	м.
волнение	ср.
лакей	м.
лето	ср.
прекрасное	ср.
состояние	ср.
бледный	прил.
известие	ср.
пальто	ср. нескл.
повесть	ж.
село	ср.
тишина	ж.
божий	прил.
глупость	ж.
мальчишка	м. разг.
связи	мн.
ус	м.
воз	м.
надел	м.
небольшой	прил.
поручик	м.
старичок	м. разг.
участие	ср.
книга	ж.
крест	м.
грусть	ж.
зеркало	ср.
лета	мн. разг.
восторг	м.
дура	ж. разг.
милость	ж.
самовар	м.
гордость	ж.
дрянь	ж. разг.
меры	мн.
отношения	мн.
преступление	ср.
кусок	м.
поэт	м.
крыльцо	ср.
полк	м.
слух	м.
власть	ж.
горло	ср.
намерение	ср.
праздник	м.
си	ср. нескл.
смысл	м.
квартира	ж.
сознание	ср.
супруга	ж.
художник	м.
воспоминания	мн.
кресло	ср.
природа	ж.
бред	м.
длинный	прил.
жид	м. разг.-сниж.
злой	прил.
ощущение	ср.
полный	прил.
приятель	м.
родная	ж. разг.
самолюбие	ср.
совет	м.
крыльца	мн. местн.
прочее	мн. нескл.
сказ	м.
усы	мн.
важное	ср.
враг	м.
начальство	ср. разг.
поклон	м.
прежнее	ср.
берег	м.
верх	м.
кровать	ж.
ложь	ж.
любопытство	ср.
поступок	м.
сумерки	мн.
закон	м.
наслаждение	ср.
срок	м.
уважение	ср.
звук	м.
подпоручик	м.
позор	м.
бывший	прил.
мешок	м.
пустой	прил. разг.
раздумье	ср.
сени	мн.
бал	м.
палец	м.
хорошее	ср.
дар	м.
край	м.
монастырь	м.
мужчина	м.
председатель	м.
прочие	мн.
решение	ср.
семена	мн.
стар	прил.
быт	м.
ил	м.
мечта	ж.
остальные	мн.
поцелуй	м.
англичанин	м.
великое	ср.
княгиня	ж.
круг	м.
парень	м. разг.
товарищ	м.
грязь	ж.
должность	ж.
музыка	ж.
начальник	м.
ост	м.
службы	мн.
тайна	ж.
бес	м. разг.
войска	мн.
гнев	м.
густой	прил.
девка	ж. разг.-сниж.
дружба	ж.
нервы	мн.
холодный	прил.
игра	ж.
личико	ср. разг.
стен	м.
учитель	м.
возможность	ж.
красный	прил.
красоты	мн. разг.
кучер	м.
отчаяние	ср.
пример	м.
ре	ср. нескл.
средства	мн.
труд	м.
фрак	м.
штука	ж.
бок	м.
след	м.
су	ср. нескл.
хорошая	ж. разг.
власти	мн.
емеля	м. разг.-сниж.
луч	м.
манилов	м. разг.
объятия	мн.
помощь	ж.
потребность	ж.
почтмейстер	м.
револьвер	м.
страшное	ср.
судья	м.
холод	м.
нога	ж.
племянник	м.
ужасный	прил.
ведьма	ж.
дуэль	ж.
жар	м.
люб	прил. разг.
причина	ж.
сухой	прил.
хвост	м.
шутка	ж.
адрес	м.
веки	мн.
значение	ср.
молодость	ж.
нож	м.
беспокойство	ср.
вес	м.
главный	прил.
глупая	ж. разг.
дым	м.
княжна	ж.
объяснение	ср.
ошибка	ж.
писатель	м.
птица	ж.
своя	ж. разг.
совесть	ж.
студент	м.
всякая	ж. разг.
гром	м.
грязи	мн.
дерево	ср.
золото	ср.
испуг	м.
присутствие	ср.
рогожина	ж. разг.
рубль	м.
рукав	м.
славный	прил.
сюртук	м.
чуб	м.
юноша	м.
каждая	ж. разг.
натура	ж.
пожар	м.
прямой	прил.
разум	м.
чистый	прил.
больная	ж. разг.
влияние	ср.
действие	ср.
отряд	м.
смешной	прил.
сцена	ж.
автор	м.
иное	ср. разг.
майор	м.
подобное	ср. разг.
разговоры	мн. разг.
свадьба	ж.
сутки	мн.
фамилия	ж.
армия	ж.
воскресенье	ср.
наука	ж.
обязанность	ж.
ожидания	мн.
собрание	ср.
забота	ж.
идеал	м.
капли	мн.
картина	ж.
огромный	прил.
одолжение	ср.
погода	ж.
прим	прил. неизм.
ребята	мн. разг.
родственник	м.
анекдот	м.
будущее	ср.
всякие	мн. разг.
досада	ж.
записки	мн.
личность	ж.
мал	прил.
мистер	м.
пакет	м.
поры	мн.
прежний	прил.
ревность	ж.
трактир	м.
барон	м.
взор	м.
воображение	ср.
кон	м.
неприятель	м.
осень	ж.
остальное	ср. разг.
решимость	ж.
свежий	прил.
унтер	м. разг.-сниж.
занятия	мн. разг.
изумруд	м.
капитал	м.
мошенник	м.
происшествие	ср.
рай	м.
скандал	м.
убийца	м. и ж.
хорошенькая	ж. разг.
этаж	м.
зверь	м.
мрак	м.
тихий	прил.
велик	прил.
вчерашний	прил.
горячий	прил.
дол	м.
женский	прил.
замечание	ср.
мгновения	мн.
мороз	м.
мост	м.
необыкновенное	ср. разг.
отцы	мн.
слабость	ж.
царь	м.
буржуа	м. нескл.
дочка	ж. разг.
зам	м. разг.
ива	ж.
карета	ж.
костюм	м.
литература	ж.
лишнее	ср. разг.
мещанин	м.
обман	м.
подбородок	м.
припадок	м.
пятна	мн.
свидание	ср.
семейство	ср.
супруги	мн.
чтение	ср.
ясный	прил.
благородие	ср.
братья	мн. разг.
воспоминание	ср.
живете	ср. нескл.
командир	м.
наказание	ср.
одеяло	ср.
озеро	ср.
пола	ж.
прах	м.
разбойник	м.
топор	м.
урок	м.
уста	мн.
хохот	м.
чулки	мн.
ящик	м.
ад	м.
бедность	ж.
билет	м.
вдова	ж.
голубой	прил.
искусство	ср.
кухарка	ж.
общий	прил.
подвиг	м.
рост	м.
спокойствие	ср.
убеждение	ср.
убеждения	мн.
дрожь	ж.
негодяй	м.
оружие	ср.
особенный	прил.
отвращение	ср.
пани	ж. нескл.
понятия	мн.
публика	ж.
сосед	м.
упор	м.
фантазия	ж.
чистое	ср. разг.
жених	м.
жест	м.
како	ср. нескл.
направление	ср.
недоумение	ср.
неожиданное	ср. разг.
несчастье	ср.
особый	прил.
площадь	ж.
справедливость	ж.
шут	м.
верный	прил.
губернатор	м.
знакомство	ср.
истина	ж.
кума	ж.
кушанье	ср.
мил	прил.
несчастная	ж. разг.
очки	мн.
предметы	мн.
пространство	ср.
раб	м.
разница	ж.
священник	м.
собственный	прил.
статья	ж.
удивление	ср.
французский	прил.
цепи	мн.
чтения	мн.
важный	прил.
встреча	ж.
горд	прил.
деда	м. разг.
дурной	прил.
негодование	ср.
номер	м.
отсутствие	ср.
повар	м.
погиб	м. местн.
подарок	м.
прошлый	прил.
сони	мн.
сумасшедшая	ж. разг.
третье	ср. разг.
формы	мн. разг.
цветок	м.
читатель	м.
война	ж.
вход	м.
горничная	ж.
гостья	ж.
животное	ср.
жилец	м.
неприятное	ср. разг.
ночной	прил.
плен	м.
покойник	м.
связь	ж.
строки	мн.
холода	мн.
борьба	ж.
воспитание	ср.
даль	ж.
дворянин	м.
достоинство	ср.
здание	ср.
коридор	м.
купец	м.
лестница	ж.
мебель	ж.
низость	ж.
перемена	ж.
песня	ж.
показание	ср.
пруд	м.
старое	ср.
усилия	мн.
цел	прил. разг.
шампанское	ср.
штаб	м.
весть	ж.
границы	мн.
коляска	ж.
нужда	ж.
пистолет	м.
простое	ср. разг.
рассудок	м.
свобода	ж.
средство	ср.
стена	ж.
суп	м.
успех	м.
хор	м.
эффект	м.
архиерей	м.
атаман	м.
библиотека	ж.
болван	м.
вчерашнее	ср. разг.
вызов	м.
губки	мн.
звон	м.
изумление	ср.
ладонь	ж.
лучи	мн.
мсье	м. нескл.
невеста	ж.
ненависть	ж.
окошко	ср. разг.
переулок	м.
проклятая	ж. разг.-сниж.
ручки	мн. разг.
сведения	мн.
скука	ж.
старики	мн. разг.
улица	ж.
вечный	прил.
глухой	прил.
графиня	ж.
грош	м.
крепкий	прил.
крыльце	ср.
луна	ж.
мокрый	прил.
низкий	прил.
опасность	ж.
папаша	м. разг.
пир	м.
появление	ср.
признак	м.
расположение	ср.
смущение	ср.
события	мн.
способности	мн.
сундук	м.
убийство	ср.
уроки	мн.
человечество	ср.
чемодан	м.
виден	прил.
глубины	мн.
горячее	ср. разг.
деятельность	ж.
душечка	м. и ж. разг.
жалость	ж.
зал	м.
монах	м.
обморок	м.
приказание	ср.
приятное	ср.
процесс	м.
следствие	ср.
сторона	ж.
тона	мн.
хозяйство	ср.
аркадия	ж.
бездна	ж.
высокое	ср.
добродетель	ж.
доказательство	ср.
записка	ж.
затылок	м.
звонок	м.
зонтик	м.
лихорадка	ж.
локоть	м.
миша	м. разг.
мрачный	прил.
название	ср.
необходимость	ж.
писарь	м.
привычка	ж.
признание	ср.
ресницы	мн.
сатана	м. и ж. разг.
свечка	ж.
сильная	ж.
стекло	ср.
утешение	ср.
халат	м.
бедняжка	м. и ж. разг.
безумная	ж. разг.
бешенство	ср.
волны	мн.
выстрел	м.
гордый	прил.
действия	мн.
единственное	ср.
журнал	м.
круглый	прил.
курс	м.
нелепость	ж.
обыкновенный	прил.
пение	ср.
подозрение	ср.
река	ж.
трава	ж.
труп	м.
усталость	ж.
шоссе	ср. нескл.
визит	м.
галстук	м.
доказательства	мн.
изверг	м.
кол	м.
краска	ж.
лужина	ж. разг.-сниж.
морской	прил.
мундир	м.
назначение	ср.
обер	м. разг.-сниж.
пароход	м.
полотно	ср.
понятие	ср.
приятный	прил.
просьба	ж.
пустое	ср.
седой	прил.
слаб	прил. разг.
слеза	ж.
совершенное	ср.
сомнение	ср.
травы	мн.
узелок	м. разг.
чина	ж.
артист	м.
беспорядок	м.
бокал	м.
борода	ж.
выход	м.
гора	ж.
государыня	ж.
действительность	ж.
дикая	ж. разг.
единственный	прил.
живое	ср. разг.
зав	м. разг.
зала	ж.
занятие	ср.
запас	м.
зять	м.
интерес	м.
исход	м.
казнь	ж.
компания	ж.
краски	мн. разг.
летний	прил.
мел	м.
милое	ср. разг.
мостовой	прил.
нежности	мн. разг.
пирог	м.
плач	м.
предприятие	ср.
презрение	ср.
розовый	прил.
светлый	прил.
сено	ср.
сиятельство	ср.
скверный	прил.
шкаф	м.
благодарность	ж.
голубушка	ж.
госпожа	ж.
деловой	прил.
деревянный	прил.
дно	ср.
жалкий	прил.
карт	м.
куча	ж.
люд	м. разг.
мелкий	прил.
немецкий	прил.
неприятность	ж.
новость	ж.
обещание	ср.
плетень	м.
подлеца	ж. разг.-сниж.
потолок	м.
похороны	мн.
предчувствие	ср.
призрак	м.
проект	м.
профессор	м.
раскаяние	ср.
родители	мн.
рыбы	мн.
следующее	ср.
сношения	мн.
стадо	ср.
толки	мн.
тревога	ж.
тревоги	мн. разг.
участь	ж.
хитрый	прил.
хлопоты	мн.
царица	ж.
блага	мн.
бричка	ж.
вагон	м.
важность	ж.
готовый	прил.
десяток	м.
документ	м.
зелень	ж.
злоба	ж.
клевета	ж.
личности	мн.
лодка	ж.
настроение	ср.
незнакомец	м.
обычай	м.
панталоны	мн.
ракитка	ж. разг.
робость	ж.
рукопись	ж.
служанка	ж.
смешное	ср.
тетрадь	ж.
храм	м.
церемонии	мн.
цыган	м.
бакенбарды	мн.
балкон	м.
благородная	ж. разг.
блондинка	ж.
грустный	прил.
гул	м.
гусар	м.
долгий	прил.
дрова	мн.
зима	ж.
кусочек	м. разг.
оскорбление	ср.
особа	м. и ж.
остатки	мн.
печальный	прил.
подполковник	м.
прошлое	ср.
ром	м.
рыцарь	м.
сострадание	ср.
спор	м.
строгий	прил.
тяжесть	ж.
удары	мн.
щи	мн.
аршин	м.
вихрь	м.
водка	ж.
жажда	ж.
жаркое	ср.
жертва	ж.
зад	м.
законы	мн.
злодей	м.
злость	ж.
исповедь	ж.
истинный	прил.
камердинер	м.
кашель	м.
ласковый	прил.
малое	ср. разг.
огород	м.
острый	прил.
паспорт	м.
перезвон	м.
печаль	ж.
поведение	ср.
полотенце	ср.
правила	мн.
преступник	м.
приключение	ср.
раба	ж.
сани	мн.
словечко	ср. разг.
собачонка	ж. разг.
терпение	ср.
фортепиано	ср. нескл.
человечек	м. разг.
чудная	ж. разг.
шельма	м. и ж. разг.
благословение	ср.
буря	ж.
высший	прил.
глубокий	прил.
дурное	ср. разг.
задумчивость	ж.
злое	ср.
инженер	м.
лишний	прил.
людской	прил.
муха	ж.
неожиданный	прил.
опытный	прил.
послед	м.
приглашение	ср.
розовые	мн.
рота	ж.
семья	ж.
сокровище	ср.
спина	ж.
уверенность	ж.
царство	ср.
человеческое	ср. разг.
благородство	ср.
вечерний	прил.
вздох	м.
вожжи	мн.
директор	м.
иск	м.
исполнение	ср.
кисть	ж.
колено	ср.
красивый	прил.
крутой	прил.
молчаливый	прил.
мышь	ж.
невинность	ж.
нетерпение	ср.
ожидание	ср.
оправдание	ср.
откровенность	ж.
перегуд	м.
песок	м.
платьице	ср. разг.
плут	м. разг.
погреб	м.
похожий	прил.
приключения	мн.
приличия	мн.
простор	м.
путешествия	мн.
пятно	ср.
разврат	м.
синий	прил.
слива	ж.
староста	м.
старость	ж.
супруг	м.
трепет	м.
фраза	ж.
четверг	м.
блаженство	ср.
богатство	ср.
большинство	ср.
бутылка	ж.
весна	ж.
вол	м.
воротник	м.
выгода	ж.
гроза	ж.
двугривенный	м. разг.
довольный	прил.
долина	ж.
дрожки	мн.
каменный	прил.
книжка	ж.
кольцо	ср.
куры	мн.
мертвец	м.
молока	ж.
молоко	ср.
няня	ж.
облако	ср.
отцов	прил. разг.
повеление	ср.
родственница	ж.
сахар	м.
свежесть	ж.
событие	ср.
соображение	ср.
сор	м.
товар	м.
тонкая	ж. разг.
уединение	ср.
услуги	мн.
французы	мн.
частный	прил.
человеческий	прил.
чудак	м.
ямщик	м.
батько	м. местн.
бледность	ж.
бра	ср. нескл.
девушкин	прил.
девчонка	ж. разг.
демон	м. разг.
денщик	м.
дерзость	ж.
жребий	м.
игумен	м.
идиот	м.
любитель	м.
любовник	м.
мисс	ж. нескл.
наружность	ж.
немцы	мн.
основание	ср.
отель	м.
парубок	м. местн.
пламя	ср.
подполье	ср.
поздний	прил.
поло	ср. нескл.
ревизор	м.
родные	мн.
святая	ж.
серебро	ср.
сети	мн.
сидевший	м.
сладкий	прил.
следователь	м.
стремление	ср.
суматоха	ж.
тарелки	мн.
телега	ж.
угрюмый	прил.
чужое	ср.
ар	м.
войско	ср.
вопль	м.
гадость	ж.
гоголь	м.
голод	м.
государство	ср.
дворня	ж.
зависть	ж.
замер	м.
звонкий	прил.
карьера	ж.
меч	м.
мыс	м.
необыкновенный	прил.
оркестр	м.
полиция	ж.
почтение	ср.
поясница	ж.
расходы	мн.
ребятишки	мн. разг.
редкость	ж.
романс	м.
рубашка	ж.
смелость	ж.
состав	м.
сотник	м.
спички	мн.
текст	м.
толстая	ж. разг.
толстяк	м. разг.
улы	мн. местн.
холодное	ср.
чужая	ж.
шапка	ж.
адъютант	м.
башмаки	мн.
браслет	м.
брюхо	ср.
быстрый	прил.
видный	прил.
гимн	м.
детство	ср.
дичь	ж.
домашний	прил.
дурень	м. разг.
знакомая	ж. разг.
колесо	ср.
короткий	прил.
кость	ж.
кур	м. местн.
лай	м.
лукавый	прил.
лучшее	ср. разг.
манеры	мн.
мишка	м. разг.
необходимое	ср.
нервный	прил.
низок	м. разг.
обыкновенное	ср. разг.
одиночество	ср.
опыт	м.
отчим	м.
показ	м.
показания	мн.
пони	м. нескл.
попа	ж. разг.
поручение	ср.
привязанность	ж.
развитие	ср.
роскошь	ж.
румянец	м.
семейные	мн. разг.
скот	м.
сок	м.
соображения	мн.
сочинитель	м.
старинный	прил.
стон	м.
странности	мн.
темноты	мн. разг.
туча	ж.
урядник	м.
уха	ж.
фальстаф	м.
фортепьяно	ср. нескл.
футляр	м.
хата	ж.
черевик	м. местн.
честная	ж. разг.
чудовище	ср.
школьник	м.
авангард	м.
боязнь	ж.
гам	м. разг.
ген	м.
громкий	прил.
грубость	ж.
грязный	прил.
дальний	прил.
денежки	мн. разг.
доверенность	ж.
донос	м.
евангелие	ср. разг.
задача	ж.
интересы	мн.
исступление	ср.
истерика	ж.
курица	ж.
лавочник	м.
личное	ср. разг.
мерзавец	м. разг.-сниж.
мечтатель	м.
надобность	ж.
наст	м.
озноб	м.
панночка	ж. разг.
пари	ср. нескл.
поминки	мн.
порок	м.
приданое	ср.
приказчик	м.
примечания	мн.
ропот	м.
сабли	мн. разг.
свидетель	м.
скорбь	ж.
спасение	ср.
ссора	ж.
сумма	ж.
топот	м.
труды	мн.
тщеславие	ср.
усилие	ср.
хитрость	ж.
хутор	м.
школа	ж.
эгоизм	м.
эгоист	м.
боковой	прил.
будущий	прил.
веселье	ср.
вой	м.
воск	м.
голубое	ср. разг.
грозный	прил.
грустное	ср. разг.
давешний	прил. разг.-сниж.
дорогая	ж. разг.
древний	прил.
жара	ж.
жаркий	прил.
жестокий	прил.
завтрак	м.
задумчивый	прил.
знаменитый	прил.
знание	ср.
зов	м.
иная	ж. разг.
кухня	ж.
ладоши	мн. разг.
лорнет	м.
масла	мн.
материал	м.
мерзость	ж. разг.
небесное	ср. разг.
недостаток	м.
нежность	ж.
нрав	м.
нужное	ср.
нынешний	прил. разг.
облом	м.
остров	м.
пары	мн.
плюшкин	м. разг.
помощник	м.
превосходный	прил.
приезд	м.
продол	м. местн.
пропил	м.
решительный	прил.
рога	мн. разг.
роковой	прил.
сверка	ж.
слабая	ж.
спас	м. разг.-сниж.
способ	м.
сравнение	ср.
старушонка	ж. разг.
сыр	м.
сюрприз	м.
физиономия	ж. разг.
христианин	м.
цена	ж.
шорох	м.
английский	прил.
англичане	мн.
асессор	м.
блюм	м.
варвар	м.
веди	ср. нескл.
голая	ж. разг.
десятка	ж.
жучка	ж. разг.
знамя	ср.
испуганный	прил.
кадриль	ж.
капля	ж.
коньяк	м.
креп	м.
литератор	м.
непонятное	ср. разг.
обида	ж.
обыкновение	ср.
одежда	ж.
перевод	м.
переход	м.
пиво	ср.
плащ	м.
поток	м.
предположение	ср.
представление	ср.
принц	м.
прошедшее	ср.
прощение	ср.
путешествие	ср.
пух	м.
рассуждение	ср.
резкий	прил.
собачий	прил.
сокровища	мн.
стройный	прил.
стужа	ж.
сумрак	м.
суходол	м.
танцы	мн. разг.
торжества	мн.
тулуп	м.
турки	мн.
туфли	мн.
тягость	ж. разг.
унижение	ср.
уныние	ср.
фонарь	м.
чистота	ж.
шаровары	мн.
экзамен	м.
ядовитый	прил.
адвокат	м.
арестант	м. разг.
бей	м.
биение	ср.
больное	ср. разг.
букет	м.
вече	ср.
виды	мн.
визг	м.
врач	м.
вред	м.
всеобщий	прил.
гимназист	м.
головки	мн.
домашние	мн. разг.
жилище	ср.
завтрашний	прил.
занавес	м.
заседатель	м.
змей	м.
зрелище	ср.
император	м.
инструмент	м.
исправник	м.
корова	ж.
крестьянин	м.
мальчиков	прил. разг.
награда	ж.
наставление	ср.
небесный	прил.
неделя	ж.
организм	м.
отделение	ср.
паром	м.
плотный	прил.
пословица	ж.
поэзия	ж.
приличный	прил.
промах	м.
разиня	м. и ж. разг.
сенцы	мн. разг.
серая	ж. разг.
смятение	ср.
солидный	прил.
странность	ж.
тронут	прил. разг.
уверенный	прил.
удивительный	прил.
улан	м.
чины	мн. разг.
чистые	мн. разг.
чрезвычайный	прил.
чувствительный	прил.
чудесное	ср.
чудный	прил.
шея	ж.
шкот	м.
аппетит	м.
арбуз	м.
безобразие	ср.
бессмертие	ср.
блюдо	ср.
болезненный	прил.
болтовня	ж.
ветерок	м. разг.
выдумка	ж.
горести	мн.
государственный	прил.
дворец	м.
дельце	ср. разг.
детки	мн. разг.
детская	ж.
законный	прил.
звание	ср.
зимний	прил.
злобный	прил.
именины	мн.
кафтан	м.
контракт	м.
коты	мн. местн.
красноречие	ср.
купол	м.
насмешка	ж.
неги	мн.
недоразумение	ср.
нежный	прил.
острога	ж.
перила	мн.
пожилая	ж. разг.
покровительство	ср.
помещица	ж.
пробор	м.
прок	м. разг.
проценты	мн. разг.
прыть	ж. разг.
пьяная	ж.
равнодушие	ср.
радостное	ср.
радостный	прил.
рапорт	м.
рассуждения	мн. разг.
родины	мн. разг.-сниж.
родитель	м. местн.
родное	ср. разг.
сияние	ср.
скромный	прил.
смирный	прил.
смотритель	м.
степь	ж.
страна	ж.
теперешнее	ср. разг.
террасы	мн.
уголь	м.
хмельной	прил. разг.
чудесный	прил.
бел	м.
беспокойный	прил.
болото	ср.
бочки	мн. разг.
буфет	м.
вальс	м.
версия	ж.
внезапный	прил.
восклицание	ср.
выбор	м.
гадкий	прил.
гвоздь	м.
голосок	м. разг.
горелки	мн.
гражданин	м.
детский	прил.
джентльмен	м.
древние	мн. разг.
заведение	ср.
закуска	ж.
замечательный	прил.
заседание	ср.
земляк	м.
именинник	м.
искренность	ж.
кнут	м.
литературный	прил.
мала	ж.
мар	м. местн.
матерь	ж. местн.
метель	ж.
миляга	м. и ж. разг.-сниж.
молитва	ж.
надпись	ж.
насмешливый	прил.
ноты	мн.
ночное	ср. разг.
обои	мн.
озадаченный	прил.
остроумие	ср.
оттенок	м.
переворот	м.
позиции	мн.
полтинник	м.
понедельник	м.
попович	м.
посещение	ср.
привидение	ср.
пророк	м.
работник	м.
роща	ж.
сарай	м.
соус	м.
спокойный	прил.
спрос	м.
студентка	ж.
тайный	прил.
теперешний	прил. разг.
торжество	ср.
тройка	ж.
тротуар	м.
усадьба	ж.
успехи	мн.
фельдфебель	м.
хранитель	м.
чепуха	ж. разг.
яблоко	ср.
яркий	прил.
базар	м.
безумие	ср. разг.
белокурый	прил.
беспокойства	мн.
близость	ж.
богатая	ж. разг.
братство	ср.
венец	м.
верхний	прил.
восток	м.
вошь	ж.
гривенник	м. разг.
грубости	мн.
дока	м. и ж. разг.
духи	мн.
жестокость	ж.
загадка	ж.
запорожец	м.
значительный	прил.
измученный	прил.
использование	ср.
кожа	ж.
количество	ср.
красавец	м.
крошечный	прил. разг.
кружка	ж.
куст	м.
лекарь	м.
ля	ср. нескл.
марокканец	м.
молоденькая	ж. разг.
мыло	ср.
мышей	м.
мясо	ср.
низкое	ср. разг.
нищая	ж. разг.
нищета	ж.
ночлег	м.
нравственность	ж.
оброк	м.
осторожность	ж.
отечество	ср.
педант	м.
платочек	м. разг.
победы	мн. разг.
поколение	ср.
полоса	ж.
посуда	ж.
потеря	ж.
праздничный	прил.
прелести	мн.
приготовления	мн.
противоположность	ж.
расстояние	ср.
расстройство	ср.
редактор	м.
ров	м.
ровный	прил.
сладкое	ср.
сожаление	ср.
сочувствие	ср.
степ	м.
странник	м.
страстный	прил.
строгость	ж.
сходство	ср.
ткач	м.
треск	м.
трико	ср. нескл.
тряпки	мн. разг.
часок	м. разг.
чахотка	ж. разг.
чудное	ср. разг.
эпизод	м.
бедняк	м.
бессилие	ср.
бешеная	ж. разг.
блестящий	прил.
бровь	ж.
варенье	ср.
великодушие	ср.
внучка	ж.
возня	ж. разг.
вопли	мн.
галушки	мн.
глушь	ж.
готовность	ж.
грубый	прил.
действительный	прил.
доход	м.
драка	ж.
дрожащий	прил.
железо	ср.
запад	м.
заступ	м.
заяц	м.
знания	мн.
знатный	прил.
известность	ж.
интересное	ср. разг.
колокол	м.
команда	ж.
комплимент	м.
конверт	м.
крайность	ж.
кружева	мн.
купе	ср. нескл.
легкомыслие	ср.
лесть	ж.
любимая	ж. разг.
мечтательность	ж.
мозг	м.
молва	ж.
мучение	ср.
невозможное	ср. разг.
недоброе	ср. разг.
нечистый	прил.
нуль	м.
обвинения	мн.
образок	м. разг.
обстановка	ж.
отступление	ср.
оттепель	ж.
офицерша	ж. разг.
пианино	ср. нескл.
письмецо	ср. разг.
пища	ж.
покрытый	прил.
полночи	ж.
постороннее	ср.
предисловие	ср.
прелестная	ж.
прилив	м.
приют	м.
проезжая	ж.
раздражение	ср.
разрыв	м.
распоряжение	ср.
сан	м.
сапожник	м.
свист	м.
свободен	прил.
сегодняшний	прил.
семинарист	м.
сиденье	ср.
слепая	ж.
соблазн	м.
совершенства	мн.
сотрудник	м.
стариков	прил. разг.
сукно	ср.
тоненький	прил. разг.
увлечение	ср.
уговор	м.
украшение	ср.
университет	м.
худое	ср.
чад	м.
чердак	м.
альбом	м.
бега	мн.
бегство	ср.
беседа	ж.
бестия	м. и ж. разг.
бесчувственный	прил.
благодать	ж.
бремя	ср.
великолепный	прил.
величие	ср.
винокур	м.
внутренний	прил.
выпал	м.
глас	м.
горькая	ж. разг.-сниж.
громадный	прил.
губернский	прил.
гувернантка	ж.
деликатный	прил.
деятель	м.
достойный	прил.
дурь	ж. разг.
жеребец	м.
знаток	м.
иволгин	прил.
игрок	м.
интересный	прил.
камин	м.
каприз	м.
катастрофа	ж.
концерт	м.
краса	ж.
кров	м.
лапки	мн. разг.
лекции	мн.
мак	м.
мастерской	прил.
медик	м. разг.
младенец	м.
мораль	ж.
мутный	прил.
недавний	прил.
недостойный	прил.
нехорошее	ср. разг.
обидчик	м.
образец	м.
осенний	прил.
ослы	мн.
отчаянная	ж. разг.
падучая	ж. разг.
палач	м.
парус	м.
петли	мн.
плат	м. нар.-поэт.
победа	ж.
побои	мн.
погоня	ж.
подаяние	ср.
полицеймейстер	м.
помещение	ср.
постоялый	прил.
поэма	ж.
преданность	ж.
приехавший	м.
приличие	ср.
процент	м.
пульс	м.
пьянство	ср.
рабство	ср.
разное	ср.
разрешение	ср.
рассказчик	м.
римский	прил.
рой	м.
рослый	прил.
саквояж	м.
скол	м.
сконфуженный	прил. разг.
смог	м.
социалист	м.
стихотворение	ср.
сырость	ж.
сюжет	м.
тесный	прил.
тогдашний	прил. разг.
турецкий	прил.
уда	ж. разг.-сниж.
уездный	прил.
хвосты	мн. разг.
хлев	м.
целковый	м.
шалунья	ж.
юный	прил.
актриса	ж.
анафема	ж.
атеист	м.
бархат	м.
басни	мн. разг.
бесценный	прил.
близкие	мн. разг.
блины	мн. разг.
бревно	ср.
будни	мн.
бюст	м.
вельможа	м.
венок	м.
вицмундир	м.
возраст	м.
воин	м.
воровство	ср.
вошедший	м.
вторник	м.
выходка	ж.
горшок	м.
груша	ж.
губернаторша	ж. разг.
диковина	ж. разг.
догадка	ж.
еврей	м.
есаул	м.
железный	прил.
замешательство	ср.
зарево	ср.
здешняя	ж. разг.
зуб	м.
инквизитор	м.
инстинкт	м.
каламбур	м.
кафе	ср. нескл.
клапан	м.
ключница	ж.
колокола	мн.
колокольчики	мн.
комод	м.
комфорт	м.
кроткий	прил.
кудри	мн.
кузнечиха	ж. разг.-сниж.
курок	м.
лесок	м. разг.
ловкий	прил.
логика	ж.
лохмотья	мн.
луг	м.
любезности	мн.
любезность	ж.
мудрость	ж.
мужской	прил.
мщение	ср.
насекомое	ср.
невестка	ж.
невинная	ж. разг.
неподвижный	прил.
низенький	прил. разг.
ножик	м. разг.
нравы	мн.
обломовщина	ж. разг.
овраг	м.
оратор	м.
осторожный	прил.
ответственность	ж.
отвратительный	прил.
открытие	ср.
отрок	м.
пансион	м.
петухи	мн. разг.
пирога	ж.
племя	ср.
подпись	ж.
покрывало	ср.
помешанная	ж. разг.
послушание	ср.
почерк	м.
правая	ж.
прапорщик	м.
предводитель	м.
предрассудки	мн.
приезжая	ж.
провал	м.
прозрачный	прил.
противник	м.
прохладный	прил.
размышление	ср.
распространение	ср.
рог	м.
розги	мн.
рубаха	ж.
светило	ср.
своеволие	ср.
сезон	м.
сеть	ж.
сиротка	м. и ж. разг.
сказанное	ср.
соседка	ж.
способный	прил.
сражение	ср.
старания	мн.
старикашка	м. разг.
стрела	ж.
строгости	мн. разг.
суета	ж.
суперкарго	м. нескл.
тарантас	м.
темя	ср.
торжественный	прил.
удовлетворение	ср.
укор	м.
упоение	ср.
упорство	ср.
усмешка	ж.
устройство	ср.
фортуна	ж.
цепь	ж.
чайник	м.
шест	м.
шпага	ж.
шпион	м.
штаны	мн.
юг	м.
юра	ж.
ярмарка	ж.
ярость	ж.
благодеяние	ср.
блин	м.
бодрый	прил.
брызги	мн.
вдохновение	ср.
ведро	ср.
величество	ср.
вечность	ж.
всегдашний	прил. разг.
голуби	мн.
голубка	ж.
городишко	м. разг.
горох	м.
графин	м.
грек	м.
грешен	прил.
грешник	м.
грядущий	прил.
допрос	м.
дорогое	ср. разг.
древности	мн.
дружище	м. разг.
жало	ср.
жинка	ж. разг.-сниж.
журналист	м.
загон	м.
закат	м.
замысел	м.
затишье	ср.
защитник	м.
издержки	мн.
изображение	ср.
изящный	прил.
кадык	м.
квас	м.
комиссар	м.
комок	м.
красивое	ср.
кувшин	м.
лесной	прил.
ломоть	м.
любопытное	ср. разг.
мор	м. разг.
мочалка	ж.
наглость	ж.
насилие	ср.
невозможность	ж.
неизъяснимое	ср.
неудача	ж.
неуклюжий	прил.
обмер	м.
осмотр	м.
отблеск	м.
отъезд	м.
очаровательный	прил.
письменный	прил.
плох	прил. разг.
повеса	м.
поворот	м.
погибель	ж. разг.
поездка	ж.
покорный	прил.
покров	м.
полковница	ж. разг.
положительный	прил.
потери	мн.
почтительность	ж.
преданный	прил.
принцип	м.
прислуга	ж.
пророчество	ср.
проступок	м.
протест	м.
противное	ср.
пушок	м. разг.
пыл	м.
ранний	прил. разг.
ресторан	м.
родство	ср.
свитка	ж.
свят	прил.
семя	ср.
система	ж.
скучный	прил.
сладострастие	ср.
слезинка	ж. разг.
смесь	ж.
смирение	ср.
совпадение	ср.
современный	прил.
сонный	прил.
сообщение	ср.
струна	ж.
сумасшествие	ср.
счастливая	ж.
сыны	мн.
турок	м.
тяжкий	прил.
угощение	ср.
умиление	ср.
ученик	м.
училище	ср.
фантастическое	ср.
хлопец	м. разг.
холодность	ж.
честность	ж.
шерсть	ж.
шерстяной	прил.
эшафот	м.
юность	ж.
ясность	ж.
авторитет	м.
амбар	м.
бабуся	ж. разг.
било	ср.
благоразумие	ср.
богач	м.
большее	ср. разг.
бородатый	прил.
брюнетка	ж.
вежливый	прил.
ветры	мн. разг.-сниж.
ветхий	прил.
взяток	м.
видимое	ср. разг.
внимательность	ж.
военное	ср.
восторженный	прил.
гамлет	м.
глубь	ж. разг.
горечь	ж.
господский	прил.
греки	мн.
гробовой	прил.
давешнее	ср. разг.-сниж.
данные	мн.
дары	мн.
деликатность	ж.
дерзкий	прил.
доброта	ж.
духота	ж.
дьякон	м.
желчь	ж.
женитьба	ж.
заботливость	ж.
заглавие	ср.
задел	м.
зерно	ср.
злобное	ср. разг.
зрение	ср.
искренний	прил.
искушение	ср.
истинное	ср. разг.
итальянцы	мн.
иуда	м. и ж.
календарь	м.
канарейка	ж.
кинжал	м.
кирпич	м.
клад	м.
клоун	м.
колорит	м.
колпак	м.
кольца	мн.
комар	м.
комиссия	ж.
кофей	м. разг.-сниж.
крупный	прил.
крылечко	ср. разг.
кустарник	м.
лампа	ж.
лампада	ж.
легкомысленный	прил.
леший	м.
ливень	м.
лоскуток	м. разг.
мадера	ж.
массы	мн.
мера	ж.
мещане	мн.
модный	прил.
музыкант	м.
мяч	м.
навес	м.
награждение	ср.
нападение	ср.
неблагодарность	ж.
неведомый	прил.
недоверчивость	ж.
неприятный	прил.
неясное	ср. разг.
обаяние	ср.
обширный	прил.
огурец	м.
озабоченный	прил.
океан	м.
окошечко	ср. разг.
омут	м.
опасный	прил.
опытность	ж.
отверстие	ср.
отрицательный	прил.
пальчик	м. разг.
памятник	м.
певец	м.
пена	ж.
перстень	м.
пехота	ж.
плутовка	ж. разг.
поверенный	м.
подобный	прил.
поединок	м.
познания	мн.
поиски	мн.
покойная	ж.
покойница	ж. разг.
портмоне	ср. нескл.
посетитель	м.
потерянная	ж.
правительство	ср.
предписание	ср.
пренебрежение	ср.
преследование	ср.
протокол	м.
прохлада	ж.
пустота	ж.
равновесие	ср.
редакция	ж.
ремесло	ср.
ростовщик	м.
рыбак	м.
свод	м.
селение	ср.
серп	м.
случившееся	ср.
соперник	м.
стоящий	прил. разг.
таинственность	ж.
таракан	м.
творчество	ср.
требование	ср.
убранство	ср.
уведомление	ср.
угроза	ж.
ужасы	мн.
указание	ср.
улика	ж.
умная	ж.
унылый	прил.
урод	м.
фантастический	прил.
фланг	м.
черевики	мн. местн.
шарманка	ж.
шелест	м.
широк	прил.
шутила	м. разг.-сниж.
щегольской	прил. разг.
яд	м.
азарт	м.
анализ	м.
аполлон	м.
арест	м.
артель	ж.
атеизм	м.
барбос	м. разг.-сниж.
баронесса	ж.
барский	прил.
бег	м.
бедняга	м. и ж. разг.
бездельник	м.
бесконечное	ср.
беспамятство	ср.
бесчестье	ср.
благоговение	ср.
блажь	ж. разг.-сниж.
ближайший	прил.
близкое	ср. разг.
бобок	м. разг.
бодрость	ж.
боевой	прил.
божество	ср.
вакса	ж.
ватага	ж. разг.
великодушный	прил.
весенний	прил.
ветка	ж.
вещица	ж. разг.
висок	м.
водевиль	м.
волоски	мн. разг.
вонь	ж. разг.
встревоженный	прил.
гадости	мн. разг.
газета	ж.
глоток	м.
голодная	ж. разг.
гробик	м. разг.
грубиян	м. разг.
гуманность	ж.
гумно	ср.
деды	мн. разг.
деревенская	ж. разг.
деспотизм	м.
дивный	прил.
доверие	ср.
должное	ср.
езда	ж.
жалобный	прил.
женихов	прил. разг.
завет	м.
загадочное	ср. разг.
зеркальце	ср. разг.
знающий	прил.
золовка	ж.
издание	ср.
издательство	ср.
излияние	ср.
икона	ж.
инвалид	м.
исключение	ср.
испытание	ср.
кандалы	мн.
капитанша	ж. разг.
карандаш	м.
клетчатый	прил.
кожаный	прил.
контраст	м.
кровавый	прил.
лента	ж.
лоск	м.
мастерица	ж.
мерзавка	ж. разг.-сниж.
месть	ж.
мешочек	м. разг.
мираж	м.
мнительность	ж.
муравей	м.
мускулы	мн. разг.
нагоняй	м. разг.
начальников	прил. разг.
недобрый	прил.
нелепый	прил.
неловкость	ж.
неслыханное	ср. разг.
обоз	м.
оборванец	м.
обрадованный	прил.
объявление	ср.
одинокая	ж. разг.
одушевление	ср.
окрестность	ж.
отдых	м.
отставка	ж.
отчество	ср.
палочки	мн.
паутина	ж.
пепел	м.
печорин	м. разг.
писание	ср.
племянница	ж.
плоть	ж.
повозка	ж.
подоконник	м.
подтверждение	ср.
подушка	ж.
поза	ж.
полом	м. разг.-сниж.
поляк	м.
поместье	ср.
помост	м.
портсигар	м.
порционный	прил.
порядки	мн. разг.
постоянный	прил.
праздный	прил.
приживальщик	м.
призвание	ср.
примета	ж.
приметы	мн.
пристальный	прил.
притворство	ср.
проворный	прил.
прогресс	м.
происшедшее	ср.
проситель	м.
простодушие	ср.
просторный	прил.
противоположный	прил.
прыжок	м.
пьяненький	прил. разг.
развлечение	ср.
разгадка	ж.
разлука	ж.
разочарованный	прил.
рана	ж.
рассудительный	прил.
рельсы	мн.
речка	ж.
рожь	ж.
рыбаков	прил. разг.
рыло	ср.
салоп	м.
самоубийство	ср.
самоуверенность	ж.
сердечная	ж. разг.
серое	ср. разг.
сизый	прил.
создатель	м.
солдатка	ж.
сорванец	м. разг.
сословие	ср.
социализм	м.
сплетня	ж.
старшие	мн.
столица	ж.
страда	ж.
строение	ср.
счастливец	м. разг.
тараса	ж.
терем	м.
транспорт	м.
тяж	м.
убыток	м.
удобство	ср.
упорный	прил.
употребление	ср.
учтивости	мн. разг.
франт	м.
чеченский	прил.
чувствительность	ж.
щенок	м.
элегия	ж.
январь	м.
алый	прил.
арьергард	м.
бабки	мн.
баловство	ср.
бараний	прил.
баркас	м.
бархатный	прил.
барчук	м. разг.
басня	ж.
бестолковый	прил.
близкий	прил.
божественный	прил.
босой	прил.
бродяга	м. и ж.
булат	м.
быль	ж.
валенки	мн.
вареник	м.
вексель	м.
верность	ж.
весельчак	м. разг.
вестник	м.
ветошка	ж.
вольнодумец	м.
вопросительный	прил.
воскресение	ср.
всадник	м.
гражданское	ср. разг.
группа	ж.
губерния	ж.
дворик	м. разг.
деспот	м.
доблесть	ж.
добродетельный	прил.
доверчивость	ж.
довольство	ср.
дож	м.
драгоценность	ж.
дурачина	м. разг.
духовенство	ср.
душевный	прил.
душный	прил.
дьяконица	ж. разг.
елей	м.
желудок	м.
зайцев	прил.
зародыш	м.
здравый	прил.
зловещий	прил.
зоркий	прил.
инок	м.
искра	ж.
итог	м.
кан	м.
каникулы	мн.
кат	м.
климат	м.
коварный	прил.
колечко	ср. разг.
конюх	м.
костра	ж.
крепостная	ж. разг.
крыло	ср.
крыша	ж.
купчик	м. разг.
лавр	м.
легенда	ж.
лентяй	м. разг.
лихорадочная	ж. разг.
ловкость	ж.
локон	м.
маскарад	м.
мачеха	ж.
мелок	м.
местность	ж.
мечеть	ж.
морген	м.
морозный	прил.
мостовая	ж.
мудрец	м.
муза	ж.
мурашки	мн.
мучительный	прил.
мыслитель	м.
наивность	ж.
начитанный	прил.
небеса	мн.
недурной	прил.
неистовый	прил.
нелепое	ср. разг.
необразованный	прил.
неосторожность	ж.
нерв	м.
неясный	прил.
низ	м.
нитка	ж.
нить	ж.
ничтожность	ж.
ничтожный	прил.
новоселье	ср.
норов	м. разг.
одобрение	ср.
омерзение	ср.
описание	ср.
основы	мн.
останов	м.
отдел	м.
отелло	м. нескл. разг.
открытый	прил.
отражение	ср.
очарование	ср.
паль	ж. местн.
панский	прил.
пейзаж	м.
переговоры	мн.
пески	мн.
песнь	ж.
печальное	ср. разг.
печка	ж. разг.
пламенный	прил.
плотник	м.
плохое	ср. разг.
подсвечник	м.
позволение	ср.
поиск	м.
покаяние	ср.
полевой	прил.
положительное	ср.
полусвет	м.
полушубок	м.
польза	ж.
поляки	мн.
помочи	мн.
понимание	ср.
порошок	м.
посланный	м. разг.
практический	прил.
пределы	мн.
предрассудок	м.
преимущество	ср.
прелестный	прил.
препятствие	ср.
приближение	ср.
привет	м.
привязанный	прил.
пропилеи	мн.
простодушный	прил.
проявление	ср.
пуд	м.
пунш	м.
пышный	прил.
пятак	м. разг.
пятнышко	ср. разг.
пяток	м. разг.
работница	ж.
равнодушный	прил.
радушие	ср.
развязность	ж.
рассвет	м.
ребе	м. нескл. разг.
религия	ж.
репутация	ж.
розовое	ср.
ротмистр	м.
самоварчик	м. разг.
свояченица	ж.
священный	прил.
сгорбленный	прил.
седло	ср.
сердечное	ср. разг.
сидевшая	ж.
силь	м.
сквозной	прил.
скрипач	м.
слесарша	ж. разг.
словарь	м.
слой	м.
служитель	м.
случайность	ж.
слышанное	ср.
смиренный	прил.
снасть	ж.
сплетник	м.
сплошной	прил.
спора	ж.
стальной	прил.
судебный	прил.
таланты	мн. разг.
творец	м.
тесть	м.
трактирный	прил.
треть	ж.
туловище	ср.
тыл	м.
умысел	м.
утренний	прил.
учение	ср.
ушки	мн.
файл	м.
фрукты	мн.
хоромы	мн. разг.
цитата	ж.
чета	ж.
чулан	м.
шалость	ж.
шалун	м.
шельмец	м. разг.
шиворот	м. разг.-сниж.
шило	ср.
явный	прил.
яс	м.
аромат	м.
аттестат	м.
батька	м. разг.-сниж.
беззаботный	прил.
белизна	ж.
берлин	м.
бесконечность	ж.
бесконечный	прил.
бесполезный	прил.
бесстыдник	м. разг.
блюдечко	ср. разг.
богиня	ж.
бородавка	ж.
брошенный	прил.
брюнет	м.
бубен	м.
будуар	м.
бурьян	м.
бытность	ж.
вдовец	м.
великолепие	ср.
величественный	прил.
вереница	ж.
ветхость	ж.
виноватая	ж. разг.
виноград	м.
внутренности	мн.
внутренность	ж.
воевода	м.
вольнодумство	ср.
воображала	м. и ж. разг.
воспитанный	прил.
восторженность	ж.
выздоровление	ср.
выигрыш	м.
галерея	ж.
гвалт	м. разг.
горесть	ж. разг.
городская	ж. разг.
гостиная	ж.
гребец	м.
грешница	ж.
грешный	прил.
груз	м.
давнее	ср. разг.
дальнейшее	ср.
диванчик	м. разг.
дивизия	ж.
добродушие	ср.
добродушный	прил.
добыча	ж.
дремота	ж.
дрозд	м.
дрянной	прил. разг.
естественный	прил.
жезл	м.
железа	ж.
житие	ср.
забитый	прил.
заблуждение	ср.
завещание	ср.
задавала	м. и ж. разг.-сниж.
задаток	м.
заметки	мн.
затмение	ср.
защита	ж.
земляника	ж.
злодеев	прил. разг.
злодейство	ср.
зной	м.
знойный	прил.
извинение	ср.
изм	м.
измена	ж.
изучение	ср.
икры	мн.
имущество	ср.
институтка	ж.
историк	м.
иудеи	мн.
капитальный	прил.
коварство	ср.
кокетство	ср.
колодезь	м.
колонна	ж.
комитет	м.
комнатка	ж. разг.
контора	ж.
крестик	м. разг.
критик	м.
кузнецов	прил. разг.-сниж.
кус	м. разг.
кухоль	м. местн.
куш	м.
лиловый	прил.
ложечки	мн. разг.
ложки	мн.
людишки	мн. разг.
марсель	м.
медальон	м.
мезонин	м.
мель	ж.
мещанка	ж.
миллионщик	м. разг.
министр	м.
мирный	прил.
мощь	ж.
мурлыка	м. и ж. разг.
наблюдение	ср.
надзор	м.
надрыв	м.
народный	прил.
национальность	ж.
невысокий	прил.
нега	ж.
недра	мн.
незабвенный	прил.
неожиданность	ж.
нервное	ср. разг.
несправедливость	ж.
неумолимый	прил.
нехорош	прил.
нехороший	прил.
носильщик	м.
нотка	ж. разг.
обеспечение	ср.
область	ж.
овал	м.
олух	м. разг.-сниж.
освещение	ср.
осетин	м.
особенность	ж.
остановившийся	прил.
охлаждение	ср.
павлин	м.
падчерица	ж.
пакость	ж. разг.
партизан	м.
перхотина	ж. разг.-сниж.
пивной	прил.
плед	м.
плохой	прил.
подпрапорщик	м.
пожатие	ср.
покровитель	м.
полководец	м.
поляне	мн.
помои	мн.
попечитель	м.
поспешность	ж.
потомство	ср.
превосходство	ср.
премудрый	прил.
прибор	м.
приветствие	ср.
прикрытие	ср.
пришедший	м.
приятность	ж.
провинциал	м.
провинция	ж.
прозаический	прил.
пронзительный	прил.
проповедь	ж.
противоречие	ср.
проход	м.
психология	ж.
пустоты	мн.
пчела	ж.
развалины	мн.
развратитель	м.
раздражительность	ж.
раздражительный	прил.
разочарование	ср.
расход	м.
риск	м.
ровня	м. и ж. разг.
ротик	м. разг.
сажа	ж.
свинство	ср. разг.
сев	м.
север	м.
сияющий	прил.
скачки	мн.
слюнки	мн. разг.
смрад	м.
снисхождение	ср.
соглас	м. местн.
соединение	ср.
спектакль	м.
список	м.
старцев	прил. разг.
столичный	прил.
столоначальник	м.
страдающий	прил.
стрельбы	мн.
строфа	ж.
струи	мн.
сударушка	ж. разг.
суждение	ср.
сумрачный	прил.
суровость	ж.
таинство	ср.
телятина	ж.
теплота	ж.
тоня	ж.
торопливый	прил.
траур	м.
трудное	ср.
труженик	м.
тупой	прил.
тятя	м. разг.-сниж.
убор	м.
уезд	м.
узенький	прил. разг.
узор	м.
упрямство	ср.
упрямый	прил.
фальшь	ж.
фуражка	ж.
хандра	ж.
харя	ж.
хват	м. разг.
хладнокровие	ср.
хриплый	прил.
частокол	м.
чаша	ж.
чепец	м.
червонцы	мн. разг.
чернила	мн.
честолюбие	ср.
четвертак	м.
шелка	мн. разг.
шубка	ж. разг.
щелчок	м.
электричество	ср.
юмор	м.
аллегория	ж.
аллея	ж.
алтарь	м.
амбиция	ж.
амур	м.
ангельский	прил.
апрель	м.
баллада	ж.
бани	мн.
бант	м.
барынька	ж. разг.
батистовый	прил.
безделица	ж. разг.
безумец	м. разг.
беспечность	ж.
беспечный	прил.
беспорядочный	прил.
беспрерывный	прил.
бессонница	ж.
бесспорный	прил.
бесстыдство	ср.
биения	мн.
благоденствие	ср.
благочестивый	прил.
богатырь	м.
бомба	ж.
бона	ж.
бурнус	м.
бурсак	м.
бурый	прил.
буфетчик	м.
быки	мн.
быстрота	ж.
варварство	ср.
вареники	мн.
величавый	прил.
вертел	м.
вечерок	м. разг.
вини	мн. разг.-сниж.
влажный	прил.
влас	м.
властелин	м.
водопад	м.
возлюбленная	ж. разг.
возможное	ср. разг.
воспитанник	м.
впечатлительность	ж.
вражда	ж.
вражий	прил.
вьюга	ж.
вялый	прил.
гармония	ж.
гарнизон	м.
гвардия	ж.
генеральский	прил.
глиняный	прил.
глупец	м.
гнусность	ж.
голубь	м.
горсть	ж.
горький	прил.
гостеприимство	ср.
грамматика	ж.
груда	ж.
гуд	м. разг.-сниж.
гульден	м.
гундосый	прил. разг.-сниж.
гусарский	прил.
действительное	ср. разг.
деньжонки	мн. разг.
деревенька	ж. разг.
деточка	ж. разг.
дефиле	ср. нескл.
дикость	ж.
диссонанс	м.
дог	м.
домишко	м. разг.
досадный	прил.
доска	ж.
дружеский	прил.
дуло	ср.
дуралей	м. разг.
дырявый	прил.
евреи	мн.
жило	ср. местн.
забвение	ср.
загадочный	прил.
задор	м.
занятой	прил.
запись	ж.
заслуга	ж.
заслуги	мн.
звучный	прил.
земное	ср. разг.
зыбь	ж.
иглу	ср. нескл.
идол	м.
изнеможение	ср.
индейки	мн.
иностранец	м.
инспектор	м.
исторический	прил.
июль	м.
казачка	ж.
казино	ср. нескл.
канал	м.
капиталы	мн. разг.
карманный	прил.
картофель	м.
катер	м.
каторжная	ж.
кельнер	м.
китель	м.
клоп	м.
козни	мн.
колдунья	ж.
комическое	ср. разг.
компот	м.
конторщик	м. разг.
копия	ж.
коричневый	прил.
коробка	ж.
корысть	ж.
космы	мн. разг.
кошечка	ж. разг.
кризис	м.
кротость	ж.
кружево	ср.
кузен	м.
кузина	ж.
курной	прил. местн.
куртка	ж.
курчавый	прил.
лавры	мн.
ларчик	м.
лафит	м.
лебедь	м.
лен	м.
лов	м.
лужа	ж.
лукавство	ср.
люстра	ж.
максим	м.
малодушие	ср.
мартын	м.
маска	ж.
масть	ж.
медицина	ж.
мерзкий	прил. разг.
мерин	м.
мистик	м.
младшая	ж. разг.
мнительный	прил.
могучая	ж. разг.
мода	ж.
морозы	мн.
мошенничество	ср.
мясник	м.
надлежащий	прил.
надменный	прил.
наивный	прил.
наказ	м.
население	ср.
наследник	м.
насморк	м.
настойчивый	прил.
настоятель	м.
нахмуренный	прил.
неблагородный	прил.
небрежность	ж.
небрежный	прил.
невидаль	ж. разг.
невольный	прил.
негодная	ж. разг.
недуг	м.
незнакомка	ж.
неизвестное	ср.
немочь	ж. разг.
неприятельский	прил.
нескромный	прил.
новичок	м.
ноябрь	м.
обет	м.
облегчение	ср.
обломок	м.
образованная	ж. разг.
обшлаг	м.
однофамилец	м.
ожерелье	ср.
окрик	м.
октябрь	м.
опус	м.
остальной	прил.
ось	ж.
отвага	ж.
откровенный	прил.
отпор	м.
отрывок	м.
очистки	мн.
пенье	ср. местн.
первенство	ср.
первоначальный	прил.
передняя	ж.
передовые	мн.
пешеход	м.
пирожное	ср.
победит	м.
побережье	ср.
повелительный	прил.
погляд	м. местн.
подбор	м.
подкрепление	ср.
подлом	м. разг.
подруга	ж.
подъезд	м.
поклонение	ср.
покупщик	м. разг.
пономарь	м.
послание	ср.
посланник	м.
постепенность	ж.
постоянство	ср.
постройка	ж.
почта	ж.
пребывание	ср.
премудрость	ж.
преподобие	ср.
приземистый	прил.
прикосновение	ср.
примирение	ср.
присев	м.
приятельница	ж.
прозвище	ср.
происхождение	ср.
прокоп	м.
просвещение	ср.
простота	ж.
процессия	ж.
прошедший	прил.
прощание	ср.
птичий	прил.
пуант	м.
пугало	ср.
путешественник	м.
путы	мн.
пылкость	ж.
рагу	ср. нескл.
разбой	м.
развит	прил.
развратный	прил.
раздор	м.
размер	м.
разрез	м.
разъезды	мн. разг.
рамки	мн.
рассеянность	ж.
растроганный	прил.
ревнивец	м.
редут	м.
резвый	прил.
рецепт	м.
решето	ср.
рождение	ср.
рубище	ср.
румяная	ж. разг.
рухлядь	ж. разг.
садовник	м.
самоуправство	ср.
сарафан	м.
сватовство	ср.
сверкающий	прил.
сговор	м.
сдержанный	прил.
секундант	м.
сигнал	м.
сидящий	м.
скарб	м. разг.
складной	прил.
склон	м.
скромность	ж.
слив	м.
смелая	ж.
смерд	м.
смеющийся	прил.
смирительный	прил.
смоль	ж.
смуглый	прил.
собачьи	мн.
сова	ж.
современник	м.
содом	м. разг.
сом	м.
сопротивление	ср.
сором	м. местн.
сосновый	прил.
сохранение	ср.
спальня	ж.
степной	прил.
стишок	м. разг.
столовая	ж.
суббота	ж.
судорога	ж.
сук	м.
сукин	прил.
сумбур	м.
сухощавый	прил.
сферы	мн.
табор	м.
тара	ж.
татары	мн.
теория	ж.
теснота	ж.
тесто	ср.
толчки	мн. разг.
томный	прил.
торопливость	ж.
тропинка	ж.
трудности	мн.
трудный	прил.
угрызение	ср.
удобный	прил.
указ	м.
умерший	м.
усердие	ср.
утомление	ср.
утопленница	ж.
ухват	м.
фальшивый	прил.
фамильярность	ж.
фартук	м.
фарфор	м.
фасон	м.
фейерверк	м.
французик	м. разг.
фри	прил. неизм.
фундамент	м.
хозяйский	прил.
холм	м.
холст	м.
хорошенькое	ср.
хромая	ж. разг.
хрустальный	прил.
художество	ср.
цепочка	ж.
церковный	прил.
цифры	мн. разг.
чаи	мн.
часочек	м. разг.
человеколюбие	ср.
червонец	м.
шарик	м. разг.
шарманщик	м.
шейх	м.
шествие	ср.
шитый	прил. разг.
шлагбаум	м.
шляхтич	м.
шрифт	м.
экземпляр	м.
элементы	мн.
эпилог	м.
южный	прил.
аккомпанемент	м.
амбиции	мн.
араб	м.
арка	ж.
ас	м. разг.
атлет	м.
атом	м.
беготня	ж. разг.
безнравственный	прил.
березина	ж. местн.
берлина	ж.
бесполезность	ж.
беспорядки	мн.
бессилен	прил.
бинокль	м.
благоприятный	прил.
благорасположение	ср.
благоухание	ср.
бритый	прил.
брюки	мн.
бубны	мн.
буйный	прил.
бульвар	м.
бурда	ж. разг.
верха	мн. разг.
ветреник	м. разг.
ветреность	ж.
вихор	м.
владение	ср.
владычица	ж.
вмешательство	ср.
вождь	м.
возмездие	ср.
вознаграждение	ср.
возражение	ср.
вонючий	прил. разг.
воплощение	ср.
вопросик	м. разг.
воровка	ж.
гарсон	м.
героиня	ж.
головная	ж. разг.
головокружение	ср.
гонор	м.
горемыка	м. и ж. разг.
горный	прил.
горячность	ж.
графинчик	м. разг.
греческий	прил.
гречиха	ж.
дамский	прил.
двоюродный	прил.
дедов	прил. разг.
дельный	прил.
деревушка	ж. разг.
детина	м. разг.
дневник	м.
добряк	м. разг.
долговязый	прил. разг.
дроги	мн. местн.
дуся	м. и ж. разг.
дюжина	ж.
дяденька	м. разг.
европейцы	мн.
естество	ср.
жадный	прил.
жандарм	м.
жгут	м.
желе	ср. нескл.
желчный	прил.
жемчуг	м.
жестяной	прил.
живопись	ж.
животы	м. местн.
жига	ж.
жирный	прил.
житель	м.
заветный	прил.
зады	мн. разг.
заклинания	мн.
замужняя	прил. разг.
занавеска	ж.
запрет	м.
землемер	м. разг.
игла	ж.
иго	ср.
избыток	м.
изложение	ср.
именьице	ср. разг.
индейка	ж.
исполинский	прил.
итальянец	м.
итальянский	прил.
казачий	прил.
капкан	м.
капуста	ж.
картишки	мн. разг.
карточки	мн.
католицизм	м.
католичество	ср.
квартет	м.
кефаль	ж.
коврик	м. разг.
кожух	м.
колет	м.
колкость	ж.
коло	ср. нескл.
колумб	м.
консул	м.
коренастый	прил.
корм	м.
корыто	ср.
кубок	м.
кучеров	прил. разг.-сниж.
лампадка	ж. разг.
ланиты	мн. нар.-поэт.
лезвие	ср.
лепет	м.
лесник	м.
лечение	ср.
литер	м.
лорд	м.
лужок	м.
лукошко	ср.
лыко	ср.
любовница	ж.
любовный	прил.
лягушка	ж.
магарыч	м. разг.-сниж.
македонский	прил.
маньяк	м.
математика	ж.
мгновенный	прил.
медленный	прил.
местоположение	ср.
милосердие	ср.
могущество	ср.
монета	ж.
монисто	ср.
мосье	м. нескл.
мощи	мн.
мускул	м.
мучитель	м.
наблюдательный	прил.
наглец	м.
наглый	прил.
народность	ж.
нарушение	ср.
наставник	м.
настой	м.
настойчивость	ж.
нация	ж.
начин	м. нар.-поэт.
неблагодарная	ж. разг.
небывалое	ср. разг.
невежество	ср.
невиданное	ср. разг.
невидимый	прил.
невыносимый	прил.
независимость	ж.
незнание	ср.
неизбежный	прил.
неловкий	прил.
немая	ж. разг.
ненавистное	ср. разг.
ненужный	прил.
неотразимый	прил.
неподвижность	ж.
непостижимое	ср.
неприличие	ср.
нерешительность	ж.
нескладный	прил.
несносный	прил.
нестерпимый	прил.
нетерпеливая	ж. разг.
неурожай	м.
нормальный	прил.
нужный	прил.
обедня	ж.
обидный	прил.
обиженная	ж.
образованность	ж.
образчик	м. разг.
обхождение	ср.
общение	ср.
объятие	ср.
обязательство	ср.
озорник	м.
окончательный	прил.
окружающие	мн.
опасение	ср.
оригинальное	ср. разг.
орудие	ср.
оселедец	м.
осиновый	прил.
ослица	ж.
основной	прил.
остроумный	прил.
отговорка	ж.
отдельный	прил.
отрывистый	прил.
отступ	м.
отчизна	ж.
очерк	м.
пасквиль	м.
пастух	м.
пекло	ср.
пеньки	мн.
передача	ж.
переезд	м.
переписка	ж.
перина	ж.
персидский	прил.
петя	м. разг.
пискун	м. разг.
пленник	м.
плоский	прил.
плуг	м.
поветовый	прил.
повтор	м.
повторение	ср.
подавленный	прил.
подрясник	м.
подьячий	м.
пожитки	мн. разг.
полукруг	м.
помехи	мн.
понятное	ср.
попечение	ср.
попов	прил. разг.
попойка	ж. разг.
поражение	ср.
портьера	ж.
потаскун	м. разг.-сниж.
поучение	ср.
похвальный	прил.
походка	ж.
похождения	мн.
православие	ср.
практика	ж.
предки	мн.
предместье	ср.
презрительный	прил.
престол	м.
претензия	ж.
преувеличение	ср.
приволье	ср.
пристань	ж.
программа	ж.
проказница	ж.
промысл	м.
проницательность	ж.
протекция	ж.
протодьякон	м.
прошлогодний	прил.
прямая	ж.
пуск	м.
пылкий	прил. разг.
пьеса	ж.
пьянчужка	м. и ж. разг.-сниж.
пятиалтынный	м.
развитой	прил.
разделение	ср.
разъезд	м.
раскрасавица	ж. разг.
расписка	ж.
рассерженный	прил.
растерянный	прил.
рвение	ср.
результат	м.
ректор	м.
ремень	м.
реформа	ж.
ритор	м.
родительский	прил.
российский	прил.
ростбиф	м.
руководитель	м.
садовый	прил.
самостоятельность	ж.
самоубийца	м. и ж.
свинцовый	прил.
святейший	прил.
северный	прил.
седенький	прил. разг.
символ	м.
синица	ж.
сказание	ср.
скамейка	ж.
сладострастник	м. разг.
слушатель	м.
собственность	ж.
сошки	мн.
спирт	м.
сруб	м.
старенький	прил. разг.
старшина	м.
страница	ж.
струя	ж.
ступни	мн. местн.
схимник	м.
тарелка	ж.
телеграмма	ж.
терновник	м.
тиран	м.
ткачиха	ж.
товары	мн.
тонкость	ж.
торговля	ж.
точный	прил.
требования	мн.
труппа	ж.
трусость	ж.
тугой	прил.
убитая	ж.
удерж	м. разг.
узок	прил.
умник	м. разг.
упавший	прил.
услуга	ж.
усталая	ж.
участник	м.
фарфоровый	прил.
февраль	м.
фламинго	м. нескл.
фокусы	мн. разг.
фомка	м. разг.
херувим	м.
хищный	прил.
хладнокровный	прил.
хлопотливый	прил.
хлопья	мн.
христианство	ср.
хуторок	м. разг.
чайный	прил.
черноглазая	ж.
шипы	мн. разг.
шоколад	м.
шулер	м.
шумок	м. разг.
шутовской	прил.
щегольство	ср.
эполеты	мн.
август	м.
австрийский	прил.
автомобиль	м.
анекдотик	м. разг.
ант	м.
аристократ	м.
аркан	м.
армейский	прил.
архив	м.
ассигнации	мн.
банки	мн.
бантик	м. разг.
барка	ж.
барс	м.
барьер	м.
батенька	м. разг.
башня	ж.
бедуины	мн.
безбожник	м. разг.
бездарность	ж.
безделье	ср.
бездыханный	прил.
безмолвие	ср.
безмолвный	прил.
белка	ж.
бескорыстный	прил.
бесов	прил.
беспомощность	ж.
бессильный	прил.
бессмыслица	ж. разг.
бит	м.
благое	ср.
близнецы	мн.
блик	м.
блондин	м.
богомолье	ср.
больница	ж.
борзой	прил.
ботинки	мн.
братия	ж.
брезгливость	ж.
брезгливый	прил.
буква	ж.
бурбон	м. разг.
бурный	прил.
былинка	ж.
важ	м.
ведущая	ж. разг.
веер	м.
великан	м.
величина	ж.
вены	мн.
верования	мн.
верхи	мн. разг.
весло	ср.
вестибюль	м.
ветреный	прил.
вис	м.
войт	м.
волчий	прил.
воробей	м.
восстание	ср.
враждебный	прил.
враки	мн. разг.
вспышка	ж.
въезд	м.
выгон	м.
вызывающий	прил.
вымысел	м.
высокомерный	прил.
выставка	ж.
гаденький	прил. разг.
газы	мн.
галиматья	ж. разг.
генеральство	ср. разг.
гениальный	прил.
гитара	ж.
гнусавый	прил.
гнусный	прил.
говорун	м. разг.
голубятня	ж.
гонение	ср.
горбатая	ж. разг.
гостеприимный	прил.
гостиница	ж.
градоначальник	м.
графский	прил.
грядущее	ср.
гуляка	м. и ж. разг.
гусиный	прил.
давний	прил.
дамочка	ж. разг.
двойной	прил.
дворники	мн. разг.
дворовая	ж. разг.
девственный	прил.
декабрь	м.
делишки	мн. разг.
дельное	ср. разг.
держиморда	м. разг.
деточки	мн. разг.
дилижанс	м.
диплом	м.
дождик	м. разг.
дозволение	ср. разг.
достаточный	прил.
доступ	м.
дощатый	прил.
дребедень	ж. разг.
дружки	мн. местн.
друз	м.
дурацкий	прил.
духовный	прил.
дых	м. разг.-сниж.
европеец	м.
единение	ср.
ефрейтор	м.
жадность	ж.
жалоба	ж.
желтоватый	прил. разг.
живость	ж.
жидовский	прил. разг.-сниж.
жизненный	прил.
журавли	мн.
забытый	прил.
завитой	прил.
загар	м.
займище	ср.
зайцы	мн.
закрой	м.
запрещение	ср.
запятая	ж.
зарница	ж.
затея	ж.
заявление	ср.
заячий	прил.
здоровенный	прил. разг.-сниж.
зипун	м.
злокачественный	прил.
золотистый	прил.
игривый	прил.
иеромонах	м.
ипохондрик	м.
исполнитель	м.
истерический	прил.
исчезновение	ср.
кавалерист	м.
каган	м.
каин	м.
кал	м.
канкан	м.
канцлер	м.
капризный	прил.
капсюль	м.
караван	м.
кипарисный	прил.
кислота	ж.
колыбель	ж.
комары	мн.
комизм	м.
конвульсии	мн.
конокрад	м.
копейка	ж.
кора	ж.
корж	м.
кормилец	м.
корсет	м.
костлявая	ж. разг.
кочевой	прил.
крайний	прил.
критика	ж.
кружевной	прил.
куплеты	мн.
лазурь	ж.
лайдак	м. разг.-сниж.
лапа	ж.
легион	м.
ледяной	прил.
лейтенант	м.
лимон	м.
листва	ж.
лишения	мн.
ломбард	м.
лоно	ср.
лягавый	м. разг.-сниж.
мадемуазель	ж. нескл.
майский	прил.
макрель	ж.
малейший	прил.
маневр	м.
манишка	ж.
масон	м.
мелюзга	ж. разг.
милостыня	ж.
минутка	ж. разг.
мистический	прил.
млечный	прил.
молебен	м.
молодайка	ж. разг.-сниж.
молокосос	м. разг.
монстр	м.
москаль	м. разг.-сниж.
мот	м.
музей	м.
музыкальный	прил.
набожный	прил.
надзиратель	м.
наименование	ср.
наклон	м.
напрасный	прил.
народец	м. разг.
наружное	ср.
натиск	м.
нахальство	ср.
начальница	ж.
невежда	м. и ж.
невозможный	прил.
невыразимое	ср. разг.
недоверчивый	прил.
нездоровье	ср.
неизвестная	ж. разг.
нелюдим	м.
немезида	ж.
ненавистный	прил.
ненаглядная	ж. разг.
неопытный	прил.
непочтение	ср.
непочтительность	ж.
неприличный	прил.
неслыханный	прил.
неуважение	ср.
неуд	м. разг.
неудовольствие	ср.
неуч	м. разг.
нива	ж.
обидчивый	прил.
обладание	ср.
обманщик	м.
обновление	ср.
обольщение	ср.
обратное	ср.
обруч	м.
обрыв	м.
общественный	прил.
объедки	мн. разг.
обычный	прил.
овин	м.
оглушительный	прил.
ограда	ж.
одеяние	ср.
однообразный	прил.
одышка	ж.
ожесточение	ср.
оказия	ж.
олимпиада	ж.
ом	м.
опал	м.
ополчение	ср.
опрятность	ж.
оса	ж.
останки	мн.
отличие	ср.
отпрыск	м.
охи	мн. разг.
очевидный	прил.
очертания	мн.
паперть	ж.
паралич	м.
паровоз	м.
пасмурный	прил.
патер	м.
пенсне	ср. нескл.
первейший	прил.
перепуганный	прил.
пересуды	мн. разг.
печень	ж.
пиджак	м.
плакса	м. и ж. разг.
плац	м.
плачущая	ж. разг.
плена	ж.
плеск	м.
плеть	ж.
побуждение	ср.
погребение	ср.
подарочек	м. разг.
подробный	прил.
подружка	ж. разг.
покорность	ж.
покрой	м.
покупатель	м.
полжизни	ж.
полудетский	прил.
полынь	ж.
помеха	ж.
поношенный	прил.
послушник	м.
потворство	ср.
почва	ж.
поэтический	прил.
пояснение	ср.
предатель	м.
предостережение	ср.
предосторожность	ж.
предсказание	ср.
презренная	ж.
преосвященный	м.
прибывший	м.
привычное	ср.
пригорок	м.
приобретение	ср.
припасы	мн.
притон	м.
проба	ж.
провиантский	прил.
продажа	ж.
продажная	ж. разг.
продолжительный	прил.
произвол	м.
промежуток	м.
проницательный	прил.
противоречия	мн.
проходивший	м.
псевдоним	м.
пташка	ж. разг.
пуговица	ж.
пузан	м. разг.
пустынь	ж.
путаница	ж.
пытка	ж.
пьедестал	м.
равная	ж. разг.
равнина	ж.
радушный	прил.
развязный	прил.
раздирающий	прил.
раздражитель	м.
разик	м. разг.
различие	ср.
размах	м.
разумное	ср.
разумный	прил.
рань	ж. разг.
распятие	ср.
рассадник	м.
рассеянный	прил.
регистратор	м.
резвость	ж.
резкость	ж.
рейтер	м.
речной	прил.
рис	м.
родина	ж.
роса	ж.
руины	мн.
рукомойник	м. разг.
рыдание	ср.
рыцарство	ср.
самолюбивый	прил.
сахара	мн.
сборник	м.
свадебный	прил.
свирепый	прил.
свободная	ж.
святотатство	ср.
святыня	ж.
сдача	ж.
сельский	прил.
сельцо	ср. разг.
середина	ж.
сидящая	ж.
симпатичный	прил.
сиплый	прил.
склонность	ж.
скорость	ж.
скрытность	ж.
слад	м. разг.-сниж.
случайный	прил.
слых	м. разг.-сниж.
смертная	ж.
смешение	ср.
совы	мн.
соки	мн.
сопоставление	ср.
сослуживец	м.
сплетница	ж.
сталь	ж.
стеклянный	прил.
стыдливый	прил.
судейский	прил.
сука	ж.
сундучок	м. разг.
супружество	ср.
танцор	м.
тат	м.
тата	м. местн.
телесный	прил.
тельный	прил. разг.-сниж.
тетрадка	ж. разг.
тигра	ж. разг.-сниж.
типун	м.
тиски	мн.
толкучий	прил. разг.-сниж.
тополь	м.
торжественность	ж.
тощий	прил.
траурный	прил.
тревожный	прил.
трибуна	ж.
трудность	ж.
тута	ж.
угрюмость	ж.
удача	ж.
удила	мн.
удушье	ср.
улыбочка	ж. разг.
умоляющий	прил.
уничтоженный	прил.
ураган	м.
успокоительное	ср.
утешитель	м.
ущелье	ср.
фант	м.
фат	м.
фельдмаршал	м.
фельетонист	м.
фидель	м.
филин	м.
финал	м.
фонтан	м.
форменный	прил.
французишка	м. разг.
фура	ж.
хворая	ж. разг.-сниж.
херес	м.
хижина	ж.
храбрость	ж.
христианка	ж.
церемония	ж.
цивилизация	ж.
цикады	мн.
цифра	ж.
цыганы	мн. разг.-сниж.
часовня	ж.
чернота	ж.
чиновница	ж. разг.
чтец	м.
чугун	м.
шальной	прил. разг.
шейный	прил.
шестилетний	прил.
шик	м.
шлях	м. местн.
шпильки	мн. разг.
шутливый	прил.
шутник	м.
щекотливый	прил.
щипцы	мн.
эгоистка	ж.
эмблема	ж.
энтузиазм	м.
энтузиаст	м.
эскадрон	м.
эфес	м.
юпитер	м.
яйцо	ср.
японец	м.
ясновельможный	прил.
ястреб	м.
административный	прил.
азиат	м.
аккуратный	прил.
акушер	м.
амплуа	ср. нескл.
амуры	мн. разг.
анатомический	прил.
антраша	ср. нескл.
апатия	ж.
арабески	мн.
арабы	мн.
ателье	ср. нескл.
аул	м.
афоризм	м.
балаган	м.
балбес	м. разг.-сниж.
башка	ж. разг.-сниж.
баштан	м. местн.
бедненький	прил. разг.
бедро	ср.
бедствие	ср.
безбожие	ср.
бездарный	прил.
безжалостный	прил.
безнравственность	ж.
безумство	ср.
бекеша	ж.
белоручка	м. и ж. разг.
белуга	ж.
бескорыстие	ср.
бесовский	прил.
беспутный	прил.
бессмысленный	прил.
бессознательное	ср. разг.
бесчестный	прил.
билетик	м. разг.
биография	ж.
бисер	м.
битки	мн. разг.
бифштекс	м.
бич	м.
благодарный	прил.
благополучие	ср.
благосклонность	ж.
благосклонный	прил.
блаженная	ж. разг.
близнец	м.
блистательный	прил.
блонды	мн.
блуза	ж.
бобрик	м.
богомольный	прил.
болт	м.
болтливый	прил.
борщ	м.
ботфорты	мн.
боцман	м.
будочник	м. разг.
бульон	м.
валет	м.
веник	м.
веретено	ср.
веретье	ср. местн.
вероятность	ж.
вертлявый	прил. разг.
верхушка	ж.
вершок	м.
весы	мн.
ветвь	ж.
взгорье	ср.
взмах	м.
взъерошенный	прил. разг.
взятка	ж.
виновник	м.
виновница	ж.
винцо	ср. разг.
виолончель	ж.
владения	мн.
внимательный	прил.
внуков	прил. разг.
возврат	м.
возвышенность	ж.
возвышенный	прил.
возглас	м.
воздушный	прил.
возок	м.
войлок	м.
волен	прил.
волшебный	прил.
воротничок	м. разг.
воспаление	ср.
восхищение	ср.
восход	м.
вояка	м. разг.
вселенная	ж.
всемирность	ж.
всхлипывание	ср.
вуаль	ж.
входной	прил.
выверт	м. разг.
вывеска	ж.
выдающийся	прил.
выделка	ж.
выпуклый	прил.
выступления	мн.
вышитый	прил.
галлюцинация	ж.
гвоздики	мн. разг.
гипноз	м.
главнокомандующий	м.
глагол	м.
говорящий	м. разг.
годовой	прил.
головушка	ж. разг.
голубки	мн. разг.
горб	м.
горнист	м.
грабли	мн.
гранаты	мн.
граница	ж.
грач	м.
грибы	мн.
гримаса	ж.
гробница	ж.
гряда	ж.
губитель	м.
гуманный	прил.
гурия	ж.
давнишнее	ср. разг.
давнишний	прил. разг.
данный	прил.
дань	ж.
дверной	прил.
дворянский	прил.
девиз	м.
декольте	ср. нескл.
диана	ж.
дикарка	ж.
довершение	ср.
дознание	ср.
должок	м. разг.
домком	м. разг.
домовой	м.
доносчик	м.
дородный	прил.
достояние	ср.
драдедамовый	прил.
дряблый	прил.
дряхлый	прил.
дубовый	прил.
думушка	ж. нар.-поэт.
дурында	м. и ж. разг.-сниж.
душистый	прил.
дыра	ж.
единичное	ср.
ежедневное	ср.
ер	м.
жабо	ср. нескл.
жидкость	ж.
жидовка	ж. разг.-сниж.
жилетка	ж. разг.
жито	ср. местн.
жук	м.
забияка	м. и ж. разг.
заветное	ср.
завистливый	прил.
заграничный	прил.
задаточек	м. разг.
задушевный	прил.
заезжая	ж. разг.
заинтересованный	прил.
законность	ж.
закрытый	прил.
залп	м.
заметный	прил.
заносчивость	ж.
запуганный	прил.
запутанный	прил.
заречье	ср.
заряженный	прил.
заслуженный	прил.
заспанный	прил.
застенчивый	прил.
заступница	ж.
затруднение	ср.
зверский	прил.
знамение	ср.
зона	ж.
зонт	м.
игуменья	ж.
изгнание	ср.
изменение	ср.
изобретение	ср.
ипподром	м.
иронический	прил.
испанец	м.
исподнее	ср. разг.-сниж.
испытующий	прил.
исследование	ср.
истома	ж.
исцеление	ср.
июнь	м.
каблук	м.
каганец	м.
казарма	ж.
казна	ж.
калитка	ж.
каллиграф	м.
камешек	м. разг.
камыш	м.
канцелярист	м.
канцелярия	ж.
капельки	мн. разг.
капельмейстер	м.
кара	ж.
карп	м.
каторжник	м.
квартирка	ж. разг.
келья	ж.
кларнет	м.
клинок	м.
клубок	м.
ключник	м.
клятва	ж.
книш	м. местн.
колдовство	ср.
колос	м.
колосс	м.
колоссальный	прил.
короли	мн. разг.
косогор	м.
костыль	м.
кофий	м. разг.-сниж.
кошачьи	мн.
краешек	м. разг.
краковяк	м.
красавчик	м. разг.
красильщик	м.
кредитный	прил.
крохи	мн. разг.
крытый	прил.
кумир	м.
кушак	м.
лавра	ж.
лампочка	ж. разг.
латы	мн.
лгун	м.
лестное	ср. разг.
лжец	м.
ливрея	ж.
литавры	мн.
лицемерие	ср.
ломберный	прил.
ломка	ж.
лохань	ж.
льстивый	прил.
любимец	м.
любопытная	ж. разг.
лютый	прил.
максима	ж.
малютка	м. и ж. разг.
манеж	м.
масленица	ж. разг.
мастерская	ж.
маятник	м.
медаль	ж.
медицинский	прил.
мелкопоместный	прил.
мелочность	ж.
мерный	прил.
метил	м.
механик	м.
мечтание	ср.
мечтательница	ж.
министерство	ср.
мирза	м.
мирон	м.
мистицизм	м.
мичман	м.
мозги	мн. разг.-сниж.
монетка	ж. разг.
мох	м.
моцион	м.
мошенница	ж.
мощный	прил.
мрамор	м.
набат	м.
наблюдатель	м.
нагой	прил.
надувание	ср.
наливка	ж.
нанятой	прил.
напиток	м.
нары	мн.
нахальный	прил.
национальный	прил.
неблагопристойный	прил.
небритый	прил.
небывалый	прил.
неведомое	ср. разг.
невероятный	прил.
невзрачный	прил.
негры	мн.
недоступный	прил.
независимый	прил.
неизбежное	ср. разг.
неисправимый	прил.
некрасивый	прил.
немалое	ср. разг.
ненужное	ср. разг.
необъятный	прил.
необычайный	прил.
неоспоримый	прил.
неотвязчивый	прил.
непосредственное	ср. разг.
непочтительный	прил.
непременный	прил.
непривычный	прил.
непротивленка	ж.
неразговорчивый	прил.
неразумное	ср. разг.
неровня	м. и ж. разг.
неряшество	ср.
нескромность	ж.
несходство	ср.
неудачный	прил.
неумолкаемый	прил.
нехристь	м. разг.-сниж.
нечаянный	прил.
нечет	м. разг.
нижнее	ср. разг.
ножичек	м. разг.
нора	ж.
норма	ж.
нравоучение	ср.
обжора	м. и ж. разг.
обитатель	м.
облик	м.
обломовский	прил. разг.
обрат	м.
обратный	прил.
обры	мн.
обряд	м.
обучение	ср.
обходительный	прил.
обязанный	прил.
однообразие	ср.
озарение	ср.
озлобление	ср.
озлобленный	прил.
окружающее	ср.
оливка	ж.
олифа	ж.
олово	м.
опрятный	прил.
опухоль	ж.
орлица	ж.
осанка	ж.
осанна	ж.
освобождение	ср.
осечка	ж.
ослушание	ср.
оспа	ж.
осуществление	ср.
отвесной	прил.
ответный	прил.
отголосок	м.
отрадный	прил.
отцеубийца	м. и ж.
отцовский	прил.
офицерик	м. разг.
офицерский	прил.
оцепенение	ср.
очевидец	м.
очипок	м.
паж	м.
парадное	ср.
параллель	ж.
параша	ж.
пасечник	м.
патриотизм	м.
пауза	ж.
пафос	м.
пациент	м.
певица	ж.
пейсики	мн. разг.
перевес	м.
перелом	м.
перепел	м.
переписчик	м.
переполох	м.
перестрелка	ж.
пери	ж. нескл.
перламутровый	прил.
песенка	ж. разг.
пест	м.
песчаный	прил.
песчинка	ж.
пики	мн.
пирожок	м. разг.
писк	м.
питомец	м.
плачевный	прил.
плечики	мн. разг.
плита	ж.
площадка	ж.
поверка	ж.
погонщик	м.
подвал	м.
подворье	ср.
поджог	м.
подкошенный	прил.
подозрительность	ж.
подпольный	прил.
подражание	ср.
подснежник	м.
подсолнечник	м.
подсудок	м.
подтяжки	мн.
подход	м.
пожарная	ж. разг.
пожелтевший	прил.
поздравление	ср.
позыв	м.
покинутый	прил.
покушение	ср.
полевые	мн.
полезное	ср. разг.
полезный	прил.
политик	м.
полой	м. местн.
полоска	ж. разг.
полоумная	ж. разг.
полтинничек	м. разг.
полумесяц	м.
полупоклон	м.
помрачение	ср.
понимающий	прил.
портфель	м.
поручи	мн.
порывистый	прил.
последствие	ср.
послушный	прил.
постановление	ср.
посторонняя	ж.
посыл	м.
потоп	м.
потроха	мн.
похвала	ж.
похмелье	ср.
похоронная	ж. разг.
почести	мн.
пошлое	ср. разг.
правильность	ж.
правитель	м.
православная	ж.
практик	м.
предзнаменование	ср.
предсмертный	прил.
предыдущий	прил.
президент	м.
преклонение	ср.
премилый	прил.
преосвященство	ср.
преследуемый	м.
пресс	м.
прехорошенький	прил.
прибрежье	ср.
прибытие	ср.
принадлежность	ж.
принуждение	ср.
припас	м.
природный	прил.
притворщик	м.
притча	ж.
прихоть	ж.
пробковый	прил.
провинциальный	прил.
проволока	ж.
прогулка	ж.
прожиток	м. разг.-сниж.
проза	ж.
прозвание	ср.
прозорливость	ж.
проигрыш	м.
проникнутый	прил.
пропись	ж.
пропитание	ср.
проповедник	м.
простонародье	ср.
простофиля	м. и ж. разг.
противоположное	ср.
прут	м.
прыщик	м. разг.
пряный	прил.
птенец	м.
пузатый	прил. разг.-сниж.
пытливый	прил. разг.
пята	ж.
пятница	ж.
равнение	ср.
радужный	прил.
размещение	ср.
разный	прил.
разочек	м. разг.
разрушение	ср.
расписной	прил.
рассматривание	ср.
рассольник	м.
растерянность	ж.
расторопный	прил.
рать	ж.
реакционный	прил.
ребро	ср.
резвушка	ж. разг.
репа	ж.
ресурсы	мн.
ретивое	ср. нар.-поэт.
ретроград	м.
решительность	ж.
родник	м.
розвальни	мн.
рознь	ж. разг.
романтика	ж.
рохля	м. и ж. разг.
рояль	м.
рублик	м. разг.
ругательство	ср.
рюмка	ж.
ряпушка	ж.
саван	м.
самозванец	м.
самолюб	м. разг.
сапожный	прил.
сафьянный	прил.
сбитый	прил. разг.
сближение	ср.
свекровь	ж.
сверхъестественное	ср.
сверчок	м.
светлица	ж.
свинец	м.
свойственный	прил.
связанный	прил.
святилище	ср.
святость	ж.
семьянин	м.
сердитая	ж. разг.
сирень	ж.
сказочный	прил.
сквер	м.
скверна	ж.
скверность	ж.
скользкий	прил.
скулы	мн.
скупость	ж.
следующая	ж.
словесность	ж.
сложение	ср.
сложности	мн.
сложный	прил.
случайное	ср.
слюна	ж.
смертельный	прил.
смешанный	прил.
смушек	м. местн.
сноп	м.
собачки	мн.
собачонок	м. разг.
собравшиеся	мн.
совещание	ср.
сознательная	ж.
соперница	ж.
соперничество	ср.
сорочка	ж.
соседний	прил.
сотрясение	ср.
соты	мн.
справедливый	прил.
спутница	ж.
средина	ж.
старичина	м. разг.
стенание	ср.
степенный	прил.
столкновение	ср.
столяр	м.
струнный	прил.
стряпуха	ж. разг.
стыдливость	ж.
субалтерн	м. разг.
сугроб	м.
суетня	ж. разг.
сурок	м.
сутулый	прил.
сухенький	прил. разг.
сюр	м. разг.
тал	м.
талантливый	прил.
талька	ж. местн.
таран	м.
теля	ср. разг.
темень	ж. разг.
темп	м.
тетерев	м.
тир	м.
тлетворный	прил.
толкования	мн.
толковый	прил.
толстовка	ж. разг.
точность	ж.
трактирщик	м.
трата	ж.
троюродный	прил.
тунеядец	м.
убежище	ср.
уверение	ср.
увоз	м.
угождение	ср.
удалец	м.
удачный	прил.
удовлетворительный	прил.
удушливый	прил.
улов	м.
улыба	м. и ж. разг.
умеренная	ж. разг.
умолчание	ср.
умы	мн. разг.
упражнения	мн.
урожай	м.
урон	м.
услужливость	ж.
услужливый	прил.
устье	ср.
уток	м.
утюг	м.
участница	ж.
учительша	ж. разг.-сниж.
фабрика	ж.
фасад	м.
фельдшер	м.
фимиам	м.
фитиль	м.
флакон	м.
флейта	ж.
формула	ж.
франко	ср. нескл.
фронт	м.
характерное	ср.
хвастун	м. разг.
херувимчик	м. разг.
хищные	мн.
хлам	м.
хлебный	прил.
хмурый	прил.
хозяйское	ср.
холодок	м. разг.
холостяк	м.
хоры	мн.
христианский	прил.
хрусталь	м.
царапина	ж.
цветочный	прил.
цветущий	прил.
целомудренный	прил.
церковное	ср.
цыгане	мн.
чайная	ж.
чарка	ж.
часик	м. разг.
чахлый	прил.
челюсть	ж.
черкесы	мн.
чернильница	ж.
черпак	м. разг.
чертовщина	ж.
чугунный	прил.
чудачества	мн. разг.
чудовищность	ж.
чулочки	мн. разг.
чуткий	прил.
шалаш	м.
шапочки	мн.
шпионство	ср.
шрам	м.
штукатурка	ж.
штыки	мн.
щепетильность	ж.
эдем	м.
экономический	прил.
экран	м.
экспертиза	ж.
электрический	прил.
энергия	ж.
этикет	м.
эхо	ср.
ягода	ж.
абсурд	м.
авто	ср. нескл. разг.
автомат	м.
авторство	ср.
агроном	м.
администратор	м.
азиатский	прил.
аи	ср. нескл.
акциз	м.
американец	м.
американцы	мн.
аннушка	ж. разг.
анонимный	прил.
антракт	м.
аплодисменты	мн.
апокалипсис	м.
апоплексический	прил.
аптекарь	м.
арифметика	ж.
арк	м.
армяк	м.
армянин	м.
армянский	прил.
артиллерия	ж.
архимандрит	м.
атташе	м. нескл.
бабий	прил. разг.
багаж	м.
багровый	прил.
бакалея	ж.
баки	мн. разг.
баловень	м.
бальзам	м.
баранина	ж.
барыш	м. разг.
батя	м. разг.
бахрома	ж.
беглец	м.
бегущий	прил.
безбрежный	прил.
безверие	ср.
беззаботность	ж.
безоблачный	прил.
безобразник	м. разг.
безопасность	ж.
безразличный	прил.
белила	мн.
бережливость	ж.
березняк	м.
беседка	ж.
беспощадный	прил.
бессвязный	прил.
бессловесная	ж. разг.
бесстрашная	ж. разг.
бестолочь	ж. разг.-сниж.
бесхарактерная	ж. разг.
библейский	прил.
бильярд	м.
благовест	м.
благой	прил.
благонамеренный	прил.
благоразумный	прил.
благословенный	прил.
блоха	ж.
блуд	м.
бобы	мн.
бойня	ж.
бон	м.
босоногий	прил.
бочонок	м.
бравый	прил.
бракосочетание	ср.
братский	прил.
бригадир	м.
бритва	ж.
брожение	ср.
бронзовый	прил.
брошь	ж.
брошюра	ж.
бугор	м.
будничный	прил.
буйство	ср.
булочник	м.
бульварный	прил.
бумеранг	м.
бурса	ж.
бутон	м.
буфетчица	ж.
ваза	ж.
вата	ж.
вахмистр	м.
ведомство	ср.
вельможный	прил.
веночек	м. разг.
вероломный	прил.
вершина	ж.
ветрогон	м. разг.
взвизг	м. разг.
взяточник	м.
видимый	прил.
виконтесса	ж.
виновность	ж.
виртуоз	м.
вихры	мн. разг.
вкусный	прил.
внешний	прил.
внешность	ж.
внук	м.
внука	ж. местн.
водолаз	м.
возбуждение	ср.
возвращение	ср.
возвышенное	ср. разг.
возможный	прил.
волостной	прил.
вольность	ж.
воришка	м. разг.
вороная	ж. разг.
воронка	ж.
воротила	м. разг.
воскресный	прил.
вошедшая	ж.
впалый	прил.
временный	прил.
времечко	ср. разг.
всенощная	ж.
выборы	мн.
выкидыш	м.
выпуск	м.
вырез	м.
высокомерие	ср.
вяз	м.
гавань	ж.
галс	м.
галстучек	м. разг.
гардероб	м.
геморрой	м.
генеральный	прил.
гениальность	ж.
география	ж.
герц	м.
герцогиня	ж.
гибкий	прил.
гибкость	ж.
гигантский	прил.
гладиатор	м.
глубина	ж.
глупенький	прил. разг.
гневный	прил.
гнилой	прил.
гниль	ж.
говядина	ж.
голубоватый	прил.
голубочка	ж. разг.
горестный	прил.
горница	ж.
гортанный	прил.
гостинец	м. разг.
грабитель	м.
грамотность	ж.
гран	м.
грань	ж.
гренадер	м.
греча	ж. разг.
гробовщик	м.
грузин	м.
грунт	м.
давка	ж.
двадцатилетний	прил.
двигатель	м.
движимый	прил.
движущийся	прил.
двуногий	прил.
двухэтажный	прил.
дебелый	прил.
дебош	м.
декорация	ж.
делец	м.
деловитость	ж.
дельфины	мн.
денежный	прил.
деревцо	ср. разг.
десятский	м.
детвора	ж.
джигит	м.
диалект	м.
дивчина	ж. разг.-сниж.
длинноволосый	прил.
доблести	мн.
доверчивый	прил.
договор	м.
дождевой	прил.
домоводка	ж. местн.
донна	ж.
допуск	м.
дороговизна	ж. разг.
дорожный	прил.
доспехи	мн.
достаток	м.
достоверность	ж.
досуг	м.
дракон	м.
древесный	прил.
древность	ж.
дремлющий	прил.
дружен	прил.
дрянцо	ср. разг.
дуга	ж.
дулебы	мн.
дупло	ср.
дурашка	м. и ж. разг.
душок	м. разг.
душонка	ж. разг.
дьячиха	ж. разг.
дядюшкин	прил. разг.
дятел	м.
европейский	прил.
ежедневный	прил.
енотовый	прил.
жад	м.
жанр	м.
жгучий	прил.
жемчужина	ж.
женин	прил. разг.
жерло	ср.
жертвенный	прил.
жизнеописание	ср.
жмурки	мн.
забавник	м.
забавный	прил.
заброшенный	прил.
завязка	ж.
загорелый	прил.
задержка	ж.
задорный	прил.
задуманный	прил.
зазимок	м. местн.
закоренелый	прил.
закутанный	прил.
заливала	м. и ж. разг.-сниж.
замкнутый	прил.
замужество	ср.
занимательный	прил.
записочка	ж. разг.
запрос	м.
запущенный	прил.
запятки	мн.
заработок	м.
заряд	м.
засаленный	прил.
заступничество	ср.
засуха	ж.
затворничество	ср.
затерянный	прил.
заунывный	прил.
заход	м.
захолустье	ср.
звено	ср.
звонарь	м.
зев	м.
землетрясение	ср.
земляной	прил.
злодейка	ж.
злодеяние	ср.
злючка	м. и ж. разг.
злющий	прил. разг.
знатность	ж.
знахарь	м.
значок	м.
золототысячник	м.
золотуха	ж. разг.
идиотка	ж.
иерей	м.
избежание	ср.
избранная	ж.
извещение	ср.
извоз	м.
извращение	ср.
изгиб	м.
изголовье	ср.
издатель	м.
изобилие	ср.
изобретатель	м.
изящество	ср.
именинница	ж.
индюк	м.
иней	м.
инерция	ж.
инициатива	ж.
иноческий	прил.
инструкция	ж.
интриган	м.
искажение	ср.
исключительность	ж.
искусный	прил.
ислам	м.
испанский	прил.
испитой	прил. разг.
исполин	м.
иссохший	прил. разг.
истый	прил.
истязатель	м.
кавалерийский	прил.
кавалькада	ж.
казакин	м.
казначей	м.
калина	ж.
каморка	ж. разг.
канитель	ж.
капиталист	м.
карлик	м.
карниз	м.
карцер	м.
катехизис	м.
католический	прил.
качели	мн.
кивер	м.
киль	м.
кипень	ж.
кирпичик	м. разг.
кисет	м.
клавикорды	мн.
клеветник	м.
клеймо	ср.
клико	ср. нескл.
кличка	ж.
кнутовище	ср.
княжество	ср.
коваль	м. местн.
козерог	м.
колбаса	ж.
коллега	м. и ж.
коллекция	ж.
колодец	м.
колодки	мн. разг.
колотушки	мн. разг.
колючий	прил.
комендант	м.
комический	прил.
компас	м.
компромисс	м.
кондрашка	м. разг.-сниж.
консилиум	м.
контроль	м.
конус	м.
конфуз	м.
кончина	ж.
копа	ж. местн.
копоть	ж.
корзина	ж.
коробок	м.
корона	ж.
коротенький	прил. разг.
коротконогий	прил.
короток	прил.
кран	м.
красивость	ж.
красненький	прил. разг.
красноватый	прил.
красноносая	ж. разг.
крашеный	прил.
кремень	м.
крендель	м.
крепостник	м.
крестник	м.
крестный	прил.
крестьянский	прил.
крикливый	прил.
кровинушка	м. и ж. нар.-поэт.
кровный	прил.
крокет	м.
крот	м.
кубовая	ж.
кубовой	прил.
кузница	ж.
кунтуш	м.
купеческий	прил.
куплет	м.
купчиха	ж.
курка	ж. местн.
курьер	м.
кухонный	прил.
ладан	м.
лакейский	прил.
лакейство	ср.
ласковость	ж.
лацкан	м.
лек	м.
ленивая	ж. разг.
летопись	ж.
ливрейный	прил.
липочка	ж. разг.
литр	м.
лифт	м.
лицей	м.
лишение	ср.
ловля	ж.
ложный	прил.
лошадиные	мн.
лошадиный	прил.
лучина	ж.
люба	ж. нар.-поэт.
любая	ж. разг.
любый	прил. нар.-поэт.
лют	прил. разг.-сниж.
мавры	мн.
мазня	ж. разг.
май	м.
малокровие	ср. разг.
маменькин	прил. разг.
марочка	ж. разг.
март	м.
массивный	прил.
мастак	м. разг.-сниж.
мастерство	ср.
мгла	ж.
медикаменты	мн.
медленность	ж.
меланхолический	прил.
мемуары	мн.
мена	ж.
ментик	м.
мерцание	ср.
металл	м.
миловидный	прил.
минувшее	ср. разг.
минутный	прил.
мириады	мн.
миска	ж.
митрополит	м.
миф	м.
многосторонность	ж.
могилка	ж. разг.
мозговой	прил.
мозжечок	м.
мозоль	ж.
моложавый	прил.
молот	м.
мольберт	м.
монарх	м.
монашество	ср.
монолог	м.
мороженое	ср.
морозец	м. разг.
морс	м.
мостки	мн.
мужичонка	м. разг.-сниж.
музыкантша	ж. разг.
мул	м.
мулла	м.
мыльный	прил.
мясоед	м. разг.
мятежный	прил.
наваждение	ср.
навык	м.
нагретый	прил.
надменность	ж.
надорванный	прил.
надтреснутый	прил.
надув	м. разг.
назидание	ср.
назойливый	прил.
наилучший	прил.
налив	м.
напев	м.
напоминание	ср.
наружный	прил.
нарыв	м.
нарядная	ж.
наседка	ж.
наскок	м. разг.
наследие	ср.
насмешливость	ж.
насущный	прил.
натуральный	прил.
нахал	м.
нашествие	ср.
небосклон	м.
невежа	м. и ж.
неверие	ср.
невестин	прил.
невестушка	ж. разг.
неглупый	прил.
негодница	ж. разг.
недоброжелательство	м.
недоверие	ср.
недовольство	ср.
недруг	м.
неестественность	ж.
незатейливый	прил.
нездешний	прил.
неземное	ср. разг.
неземной	прил.
незнакомая	ж. разг.
незначительный	прил.
неистовство	ср.
неколебимый	прил.
нелюдимость	ж.
немаловажный	прил.
неминуемое	ср.
немчик	м. разг.
ненастье	ср.
необходимый	прил.
необъятное	ср.
неописанный	прил.
непогода	ж.
непоколебимый	прил.
непонимание	ср.
непорочность	ж.
непрерывный	прил.
неприступный	прил.
неприязнь	ж.
непробудный	прил.
непротивление	ср.
неравенство	ср.
неразумная	ж. разг.
несвязный	прил.
несогласие	ср.
несообразность	ж.
несравненная	ж. разг.
несущий	прил.
неугомонный	прил.
неутомимый	прил.
нечеловеческий	прил.
ничья	ж.
новшество	ср.
ноль	м.
норд	м.
ноша	ж.
оазис	м.
обезглавленный	прил.
обеспеченный	прил.
обзор	м.
обидчивость	ж.
обладатель	м.
облачко	ср. разг.
обличитель	м.
обманчивый	прил.
обозрение	ср.
обольститель	м.
обольстительница	ж.
обольстительный	прил.
обрубок	м.
обтянутый	прил.
огниво	ср.
огорчение	ср.
ода	ж.
одинаковый	прил.
одноэтажный	прил.
окаменелый	прил.
оклик	м.
окованный	прил.
околыш	м.
окостенелый	прил.
оловянный	прил.
онемение	ср.
опека	ж.
опиум	м.
оплошность	ж.
опьянение	ср.
оранжерея	ж.
ординарность	ж.
ореол	м.
орлиный	прил.
оселок	м.
ослепление	ср.
отважный	прил.
отвал	м.
отеческий	прил.
отклик	м.
отлучение	ср.
отмщение	ср.
относ	м.
отпевание	ср.
отрава	ж.
отречение	ср.
отрочество	ср.
отсек	м.
отход	м.
отшельник	м.
официальный	прил.
очарованный	прил.
очевидность	ж.
очертание	ср.
павильон	м.
падеж	м.
палаш	м.
панорама	ж.
панталончики	мн. разг.
парадный	прил.
пасьянс	м.
пах	м.
пачкун	м. разг.
паша	м.
пенаты	мн.
пенс	м.
пенька	ж.
переводчик	м.
перегородка	ж.
перекупка	ж.
перенос	м.
переправа	ж.
перерыв	м.
пересек	м. местн.
переселение	ср.
персонаж	м.
перспективы	мн. разг.
пестрота	ж.
пианистка	ж.
пивная	ж.
планета	ж.
плата	ж.
платьишко	ср. разг.
плахта	ж.
плечистый	прил.
плюгавенький	прил. разг.
побегушки	мн. разг.
побоище	ср.
побочный	прил.
поварской	прил.
повелитель	м.
повытчик	м.
повышение	ср.
погодка	ж. разг.
погост	м.
подвески	мн.
подвох	м. разг.
подготовка	ж.
подземелье	ср.
подземный	прил.
подкова	ж.
подмен	м.
подозрительный	прил.
подошва	ж.
подпал	м.
подписка	ж.
подражатель	м.
подросток	м.
подходящий	прил.
пожелание	ср.
позеленевший	прил.
позиция	ж.
позорный	прил.
пойма	ж.
поклажа	ж.
покойников	прил. разг.
полдневный	прил. местн.
полемический	прил.
полесье	ср.
политика	ж.
полномочия	мн.
полнота	ж.
полусонный	прил.
получение	ср.
полцены	ж.
полшага	м.
помога	ж. разг.-сниж.
попытка	ж.
порождение	ср.
портер	м.
портниха	ж.
портплед	м.
порты	мн. разг.-сниж.
портье	м. нескл.
поручни	мн. местн.
поселение	ср.
постелька	ж. разг.
постник	м. разг.
поступь	ж.
потемневший	прил.
потомки	мн.
потомок	м.
похищение	ср.
походный	прил.
почтительный	прил.
почтмейстерша	ж. разг.
пошленький	прил. разг.
пошляк	м. разг.
поэмка	ж. разг.
правдивый	прил.
правые	мн.
праздность	ж.
прачка	ж.
превеликий	прил.
предательство	ср.
преддверие	ср.
предобрый	прил.
предпочтение	ср.
предприимчивость	ж.
прелюбопытный	прил.
препустой	прил.
преступница	ж.
прибавка	ж. разг.
прибывшая	ж.
приветливый	прил.
привилегия	ж.
приготовление	ср.
приживал	м. разг.
приживалка	ж. разг.
прикованная	ж.
принадлежности	мн.
присмотр	м.
пристанище	ср.
пристрастие	ср.
присутствовавший	м.
притвора	м. и ж. разг.
притворщица	ж.
приторный	прил.
прихожая	ж.
прицел	м.
пришествие	ср.
пробуждение	ср.
провинциалка	ж.
проворство	ср.
прогон	м.
продовольствие	ср.
продукты	мн.
происходящее	ср.
проказник	м.
прорез	м.
прореха	ж.
просак	м. местн.
простоватый	прил. разг.
простокваша	ж.
простуда	ж.
проток	м.
протопоп	м.
протопопша	ж. разг.
проулок	м. разг.
проходившая	ж.
прочитанное	ср.
прочувствованное	ср.
прошение	ср.
прощелыга	м. и ж. разг.-сниж.
прыткий	прил. разг.
прямодушный	прил.
псаломщик	м.
псарь	м.
псих	м. разг.-сниж.
психологический	прил.
пугливый	прил.
пузо	ср. разг.-сниж.
пустошь	ж. разг.
путешественница	ж.
путник	м. разг.
путное	ср. разг.
рабыня	ж.
разбитной	прил.
разбойница	ж.
развратник	м.
развращение	ср.
разговорчивый	прил.
разгулье	ср. разг.
раздетый	прил.
разлад	м.
размен	м.
размолвка	ж.
разнообразие	ср.
разок	м. разг.
разорение	ср.
расправа	ж.
распущенность	ж.
расцвет	м.
ревматизм	м.
реестр	м.
резиновый	прил.
резон	м.
резь	ж.
рейтузы	мн.
рекомендация	ж.
республика	ж.
ржание	ср.
риска	ж.
рисунок	м.
родич	м.
розовенький	прил. разг.
росчерк	м.
ружьецо	ср. разг.
румяна	мн.
русло	ср.
рыжеватый	прил.
рысак	м.
сакс	м.
самодовольный	прил.
самомнение	ср.
самопожертвование	ср.
самоучка	м. и ж. разг.
санкция	ж.
сбережения	мн.
сбора	ж.
свалка	ж.
сведущий	прил.
свинина	ж.
свирель	ж.
свитой	прил.
сдержанность	ж.
седины	мн.
седок	м.
сема	ж.
сенатор	м.
сентиментальность	ж.
сентябрь	м.
сервиз	м.
сердобольная	ж. разг.
серна	ж.
сибирский	прил.
сиг	м.
сигара	ж.
силища	ж. разг.
силуэт	м.
синеватый	прил.
сироп	м.
сиротство	ср.
сито	ср.
ситцевый	прил.
скачок	м.
скворец	м.
скворушка	м. разг.
скит	м.
скорлупа	ж.
скотский	прил.
скрытный	прил.
сладости	мн.
сладостный	прил.
сласть	ж. разг.-сниж.
слом	м.
смельчак	м. разг.
смешки	мн. разг.
смешок	м. разг.
смолы	мн.
снежки	мн.
сновидение	ср.
снохач	м. разг.-сниж.
собеседник	м.
соболезнование	ср.
собственник	м.
соглашение	ср.
содействие	ср.
содрогание	ср.
сожительница	ж.
созвездие	ср.
солидность	ж.
солома	ж.
сомнительный	прил.
соответственный	прил.
сопля	ж. разг.-сниж.
сопляк	м. разг.-сниж.
соседский	прил.
сосновые	мн.
сосредоточенность	ж.
сосредоточенный	прил.
сострадательный	прил.
социальный	прил.
сочетание	ср.
сочинительница	ж.
спаситель	м.
спасительный	прил.
списочек	м. разг.
спуск	м.
срамник	м. разг.-сниж.
старичишка	м. разг.
статный	прил.
стебель	м.
стенной	прил.
стишонки	мн. разг.
столетие	ср.
столетний	прил.
стрельба	ж.
стриженая	ж. разг.
строитель	м.
стройка	ж.
стройность	ж.
стряпчий	м.
суеверие	ср.
суетливость	ж.
суконный	прил.
сумасброд	м. разг.
сумеречный	прил.
сумятица	ж. разг.
сухость	ж.
существительное	ср.
схватки	мн.
сходка	ж.
сынишка	м. разг.
сыночек	м. разг.
сыры	мн.
сытая	ж.
сытный	прил.
сыщик	м.
сэр	м.
табачный	прил.
табло	ср. нескл.
такси	ср. нескл.
талес	м.
тангенс	м.
текущее	ср.
телеграфист	м.
телеса	мн. разг.
телесное	ср.
типография	ж.
товарищество	ср.
толкование	ср.
толкотня	ж. разг.
торговка	ж.
травля	ж.
трагическое	ср.
трескотня	ж. разг.
трескучий	прил.
трибун	м.
трусишка	м. разг.
трусы	мн.
тряпица	ж. разг.
туманы	мн.
турусы	мн. разг.
турухтан	м.
тусклый	прил.
тучный	прил.
тщеславный	прил.
тыква	ж.
тысячелетний	прил.
тюремный	прил.
тюрьма	ж.
убийственный	прил.
увесистый	прил.
углубление	ср.
угорелый	прил. разг.
удавление	ср.
удалой	прил.
узник	м.
уклон	м.
украинский	прил.
уловка	ж.
улучшение	ср.
упитанный	прил.
упругий	прил.
уступчивость	ж.
утварь	ж.
училищный	прил.
учтивость	ж.
ушат	м.
ушиб	м.
уют	м.
фата	ж.
фен	м.
фес	м.
физик	м.
филантроп	м.
финский	прил.
фортель	м. разг.
франтовской	прил.
фрау	ж. нескл.
фураж	м.
фурор	м.
фурьерист	м.
харчевня	ж.
харчи	мн. разг.-сниж.
химия	ж.
хитреца	ж. разг.
хлопотун	м. разг.
хмара	ж. местн.
ходьба	ж.
хозяюшка	ж. разг.
хруст	м.
хрыч	м. разг.-сниж.
царевич	м.
цветное	ср.
целомудрие	ср.
целость	ж.
цензура	ж.
церковнослужитель	м.
цимбалы	мн.
чахоточная	ж. разг.
черноволосая	ж.
чехол	м.
чинный	прил.
читальщик	м. разг.
чопорный	прил.
чувственность	ж.
чудачка	ж.
чудище	ср. разг.
чудотворный	прил.
шавка	ж. разг.
шалфей	м.
шары	мн. разг.-сниж.
швейцарец	м.
шестидесятилетний	прил.
шифон	м.
шкатулка	ж.
шлык	м.
шнурочек	м. разг.
штиблетишки	мн. разг.
штиль	м.
штора	ж.
шумливый	прил.
шутовство	ср.
щеголиха	ж.
щедрость	ж.
щепка	ж.
щетина	ж.
экивоки	мн.
экстренный	прил.
эпиграмма	ж.
эпиграф	м.
эполет	м.
эпос	м.
эфиопы	мн.
юмористический	прил.
юродивая	ж.
яблочко	ср. разг.
язвительный	прил.
яичница	ж.
яровое	ср.
аббат	м.
аболиционист	м.
абсолютный	прил.
авантюрный	прил.
адресный	прил.
аист	м.
аквариум	м.
аккуратность	ж.
акрополь	м.
аксиома	ж.
алчность	ж.
альфонс	м.
амвон	м.
ананас	м.
анекдотец	м. разг.
аноним	м.
антиподы	мн.
антоновка	ж.
антресоли	мн.
аншеф	м. разг.
апельсин	м.
аптекарский	прил.
арапник	м.
арена	ж.
аренда	ж.
арии	мн.
аристократизм	м.
ария	ж.
ароматический	прил.
ароматный	прил.
артиллерийский	прил.
артистка	ж.
арфа	ж.
археолог	м.
архиепископ	м.
архитектор	м.
аспиды	мн.
атеистический	прил.
атласный	прил.
афиша	ж.
афишка	ж. разг.
ахинея	ж. разг.
ацтеки	мн.
багряный	прил.
база	ж.
бакенбарда	ж.
баклуши	мн. местн.
балагур	м. разг.
балдахин	м.
балык	м.
бальзамический	прил.
бандурист	м.
банковый	прил.
банкротство	ср.
баночки	мн. разг.
барометр	м.
барочник	м.
баррикада	ж.
барщина	ж.
барышник	м. разг.
батальон	м.
беглая	ж. разг.
беговой	прил.
беж	прил. неизм.
безвредный	прил.
безгласный	прил.
безграничность	ж.
безграничный	прил.
безгрешный	прил.
беззаконие	ср.
беззащитный	прил.
беззвучный	прил.
безногая	ж. разг.
безоблачность	ж.
безответный	прил.
безотрадный	прил.
безрассудство	ср.
безродная	ж.
безрукавка	ж.
безучастный	прил.
бели	мн.
белобрысый	прил. разг.
белочка	ж. разг.
бельишко	ср. разг.
бельэтаж	м.
бенедиктинцы	мн.
бесподобный	прил. разг.
беспомощный	прил.
беспошлинный	прил.
беспристрастие	ср.
бессердечный	прил.
бесславие	ср.
бессмысленность	ж.
бессовестная	ж. разг.
бесстыдница	ж. разг.
бестактность	ж.
бесцветный	прил.
бесцельность	ж.
бесцеремонность	ж.
бесчинство	ср.
благовоние	ср.
благоговейный	прил.
благодушие	ср.
благонамеренность	ж.
благопристойный	прил.
благосостояние	ср.
блажной	прил. разг.-сниж.
блеяние	ср.
ближние	мн.
блокнот	м.
блондиночка	ж. разг.
блуждающий	прил.
бобровый	прил.
бобыль	м.
богадельня	ж.
богомолец	м.
боец	м.
болгарин	м.
большеголовый	прил.
больший	прил.
болячка	ж. разг.
боскет	м.
ботвинья	ж.
брачный	прил.
бредни	мн. разг.
бритвенный	прил.
бронза	ж.
брошка	ж. разг.
брошюрка	ж. разг.
бублик	м.
бубновый	прил.
будка	ж.
бук	м.
букварь	м.
букетик	м. разг.
булка	ж.
булочка	ж. разг.
булыжник	м.
бунчужный	м.
бурнусик	м. разг.
бурский	прил.
бутерброд	м.
бутыль	ж.
бытовой	прил.
бюстик	м. разг.
валенок	м.
валериана	ж.
валлон	м.
ванная	ж.
ванны	мн.
ванный	прил.
вар	м.
вариация	ж.
ватт	м.
введение	ср.
вдох	м.
вдохновенный	прил.
вековечный	прил.
вековой	прил.
величавость	ж.
велосипед	м.
венгерский	прил.
венецианский	прил.
венский	прил.
венчание	ср.
верба	ж.
верблюд	м.
вериги	мн.
вероломство	ср.
веский	прил.
веснушки	мн.
весточка	ж. разг.
веточка	ж. разг.
ветчина	ж.
взаимность	ж.
взаимный	прил.
взятие	ср.
виденное	ср. разг.
визгливый	прил.
вилка	ж.
вилок	м. разг.
винный	прил.
винтовка	ж.
винтовой	прил.
виртуозка	ж. разг.
вирши	мн.
виселица	ж.
висельник	м.
вишня	ж.
владелец	м.
владычество	ср.
властность	ж.
властный	прил.
влиятельный	прил.
внуки	мн.
воеводство	ср.
возбуждающий	прил.
воздержание	ср.
воззвание	ср.
возмущение	ср.
возница	м.
возобновление	ср.
воинственный	прил.
волдырь	м.
волнующий	прил.
волшебство	ср.
волюшка	ж. нар.-поэт.
вопиющий	прил.
вопрошающий	прил.
воспитательный	прил.
восприимчивость	ж.
востренький	прил. разг.-сниж.
востроногий	прил. разг.-сниж.
восхождение	ср.
временной	прил.
всадники	мн.
вступление	ср.
второстепенное	ср. разг.
вхож	прил. разг.
выгодный	прил.
выделанный	прил.
выдуманный	прил.
выздоравливающий	м. разг.
выкат	м. разг.
выкройка	ж.
вылитый	прил. разг.
выпад	м.
выселок	м.
высота	ж.
высохший	прил.
высочайший	прил.
выстриженный	прил.
выступ	м.
выступление	ср.
высь	ж.
выходец	м.
вязание	ср.
вялость	ж.
газетчик	м. разг.
галушка	ж.
гарусный	прил.
гвардейский	прил.
гвоздик	м. разг.
геологический	прил.
гербовый	прил.
геркулес	м.
героизм	м.
гибка	ж. разг.
гимназистка	ж.
гипотеза	ж.
гипсовый	прил.
глаголь	м.
гладкая	ж. разг.
глазомер	м.
гласность	ж.
глина	ж.
глобус	м.
глоточек	м. разг.
глубокомысленный	прил.
глуповатый	прил.
глянец	м.
гной	м.
гну	м. нескл.
голландский	прил.
головорез	м. разг.
голодуха	ж. разг.-сниж.
гололедица	ж.
голосистый	прил.
голубонька	ж. разг.
голяк	м. разг.-сниж.
гомерический	прил.
гомон	м. разг.
гон	м.
гончая	ж. разг.
гопак	м.
гордячка	ж. разг.
горемычная	ж. разг.
горловой	прил.
гортань	ж.
господствующий	прил.
готский	прил.
грабительство	ср.
гравий	м.
грамотей	м. разг.
граната	ж.
гречанка	ж.
грешное	ср. разг.
громовержец	м.
грошик	м. разг.
грушевый	прил.
грызло	ср.
губернаторский	прил.
гудение	ср.
гулкий	прил.
гульня	ж. разг.-сниж.
гущина	ж. разг.
давление	ср.
дальнейший	прил.
дамка	ж.
даровитый	прил.
двенадцатилетний	прил.
дворишко	м. разг.
дворняжка	ж. разг.
двусмысленный	прил.
дебри	мн.
деверь	м.
девический	прил.
девственник	м.
девственность	ж.
девчата	мн. разг.
дежурство	ср.
действительная	ж. разг.
дека	ж.
деликатес	м.
демократический	прил.
денщиков	прил. разг.
держава	ж.
детище	ср.
джин	м.
дивизион	м.
динарий	м.
дипломатка	ж. разг.
диск	м.
длинен	прил.
длинноухий	прил.
дневной	прил.
добришко	ср. разг.
доброжелатель	м.
довод	м.
дождливый	прил.
доклад	м.
докторша	ж.
докука	ж. разг.-сниж.
докучный	прил. разг.
долговой	прил.
должник	м.
допущение	ср.
доставала	м. и ж. разг.
достижение	ср.
достоверный	прил.
достопримечательный	прил.
дочечка	ж. разг.
драгоценная	ж. разг.
дребезжащий	прил.
древко	ср.
древляне	мн.
дремучий	прил.
дрожание	ср.
дудка	ж.
дурачество	ср.
дурман	м.
дурнушка	ж. разг.
духовник	м.
духовой	прил.
дуэт	м.
дылда	м. и ж. разг.-сниж.
дядин	прил.
егерский	прил.
егерь	м.
егоза	м. и ж. разг.
еда	ж.
екатерининский	прил.
ель	ж.
ельник	м.
ерунда	ж. разг.
ершишка	м. разг.
жабры	мн.
жареный	прил.
жарища	ж. разг.
жарок	м.
желаемое	ср.
желтолицый	прил.
женоподобный	прил.
жеребчик	м. разг.
жеребячий	прил.
животный	прил.
живущая	ж. разг.
жидкий	прил.
жидомор	м. разг.-сниж.
жижа	ж.
жилистый	прил.
жилой	прил.
жимолость	ж.
житница	ж.
жокей	м.
жрец	м.
жужжание	ср.
жулик	м. разг.
заблудший	прил.
забулдыга	м. и ж. разг.-сниж.
заводила	м. и ж. разг.-сниж.
завоеватель	м.
завтрашнее	ср.
загляденье	ср. разг.
заграница	ж. разг.
задвижка	ж.
задняя	ж. разг.
задыхающийся	прил.
зажиточный	прил.
зазнобушка	м. и ж. нар.-поэт.
зазорный	прил. разг.-сниж.
законченный	прил.
заливчик	м. разг.
замарашка	м. и ж. разг.
занавесь	ж.
заносчивый	прил.
заношенный	прил.
запальчивый	прил.
запой	м.
запуганность	ж.
запустение	ср.
засов	м.
застой	м.
затверженный	прил.
заученный	прил.
зачатки	мн. разг.
зачинщик	м.
зеленоватый	прил.
зелье	ср.
земляков	прил. разг.
земь	ж. разг.-сниж.
зенит	м.
зеркальный	прил.
злословия	мн. разг.
зоб	м.
зола	ж.
зоологический	прил.
зубоскал	м. разг.
зубоскальство	ср. разг.
зубчатый	прил.
зыбка	ж. местн.
зыбкий	прил.
зычный	прил.
иволга	ж.
играющий	м. разг.
игривость	ж.
идейка	ж. разг.
идолов	прил. разг.
идолопоклонник	м.
иждивение	ср.
ижица	ж.
избушка	ж. разг.
известковый	прил.
изгнанник	м.
издевательство	ср.
изжога	ж.
излишек	м.
излишнее	ср. разг.
излом	м.
изломанный	прил.
излюбленный	прил.
изменница	ж.
изморозь	ж.
изношенный	прил.
изнурение	ср.
изобретательный	прил.
изорванный	прил.
изразцы	мн.
изречение	ср.
изуверство	ср.
изъян	м.
иконостас	м.
императрица	ж.
индейский	прил.
иностранка	ж.
иностранный	прил.
иноходец	м.
интеллигентный	прил.
интервал	м.
интимности	мн. разг.
интимный	прил.
интонация	ж.
исконный	прил.
искупление	ср.
искусник	м. разг.
испанцы	мн.
испорченный	прил.
истеричный	прил.
истолкование	ср.
истребление	ср.
ищущий	прил.
кадильный	прил.
кадочка	ж. разг.
кадушка	ж.
казуист	м.
казуистика	ж.
казус	м.
калач	м.
калека	м. и ж.
каменистый	прил.
камергер	м.
каморочка	ж. разг.
канат	м.
канва	ж.
канон	м.
капиталец	м. разг.
капиталистка	ж. разг.
капор	м.
каравай	м.
карикатурный	прил.
кармазин	м.
карта	ж.
карьерист	м.
кассир	м.
катакомбы	мн.
категорический	прил.
католичка	ж.
кашемировый	прил.
кибитка	ж.
кий	м.
киоск	м.
кипарис	м.
кираса	ж.
кислый	прил.
кислятина	ж. разг.
кишки	мн. разг.
кладовая	ж.
классная	ж.
клиент	м.
кликуша	м. и ж. разг.
клобук	м.
клочка	ж. местн.
клубный	прил.
клятвопреступница	ж.
книжный	прил.
княжеский	прил.
кобель	м.
кобеняк	м.
кобылица	ж.
ков	м.
ковач	м. местн.
ковшик	м. разг.
козий	прил.
койка	ж.
кокотка	ж.
кола	ж.
колебание	ср.
колеблющаяся	ж. разг.
колесни	мн. местн.
колокольня	ж.
колонист	м.
колония	ж.
колоннада	ж.
кольчуга	ж.
комара	ж.
комиссионер	м.
комочек	м. разг.
компактный	прил.
комплект	м.
конвертик	м. разг.
конгресс	м.
кондитерская	ж.
конница	ж.
конский	прил.
контра	м. и ж. разг.-сниж.
контрабас	м.
коньки	мн.
коньячок	м. разг.
копал	м.
копт	м.
коренная	ж. разг.
корка	ж.
кормилица	ж.
короб	м.
коровий	прил.
коронный	прил.
корчмарь	м.
коршун	м.
корюшка	ж.
косматый	прил.
костяк	м.
косынка	ж.
косыночка	ж. разг.
котов	прил. разг.
кофта	ж.
кочевье	ср.
кочет	м. местн.
кража	ж.
крапива	ж.
краснобай	м. разг.
красноречивый	прил.
краюшка	ж. разг.-сниж.
крем	м.
кремль	м.
крестины	мн.
крещение	ср.
кровное	ср. разг.
кровотечение	ср.
крокодил	м.
крокодилов	прил.
кропотун	м. разг.-сниж.
крохотный	прил. разг.
кругленький	прил. разг.
круговой	прил.
круговорот	м.
кружевница	ж.
крутенек	прил. разг.
крылатый	прил.
кудель	ж.
кудрявый	прил.
кукиш	м. разг.
кули	м. нескл.
купальный	прил.
купель	ж.
кураж	м. разг.
курсы	мн.
кут	м. местн.
кутила	м. и ж. разг.
лабардан	м.
лавочный	прил.
лавчонка	ж. разг.
лазарет	м.
лазейка	ж.
лакейская	ж.
лакомый	прил.
ландо	ср. нескл.
ландшафт	м.
лань	ж.
лапоток	м. разг.
лары	мн.
ларь	м.
латынь	ж. разг.
лгунишка	м. и ж. разг.
легковерный	прил.
легкокрылый	прил.
леди	ж. нескл.
лей	м.
лексикон	м.
лектор	м.
лесишко	м. разг.
леска	ж.
лилия	ж.
лихорадочность	ж.
ловелас	м.
ловушка	ж.
логистика	ж.
лодочник	м.
ломбардный	прил.
лопата	ж.
лоскутник	м. разг.
лоскутья	мн. разг.
лохматый	прил.
лужица	ж. разг.
лунатик	м.
лунь	м.
лыжи	мн.
лысина	ж.
львица	ж.
льдинка	ж. разг.
льстец	м.
любимица	ж.
любительница	ж.
любое	ср.
любушка	ж. нар.-поэт.
людный	прил.
ляп	м. разг.
лясы	мн. разг.-сниж.
маг	м.
магический	прил.
магнетизм	м.
мадонна	ж.
макушка	ж.
малаец	м.
мальчишечка	м. разг.
мальчуган	м. разг.
малявочка	м. и ж. разг.
мания	ж.
маршальский	прил.
математик	м.
математический	прил.
матрос	м.
мачта	ж.
маяк	м.
мегера	м. и ж. разг.-сниж.
медовый	прил.
международный	прил.
мелодрама	ж.
меньшая	ж. разг.-сниж.
меняла	м. и ж. разг.
меринок	м. разг.
мерка	ж.
месье	м. нескл.
метафора	ж.
методичность	ж.
меховой	прил.
мещаночка	ж. разг.
мизинец	м.
мизинчик	м. разг.
микроскоп	м.
милка	ж. разг.-сниж.
милосердный	прил.
минарет	м.
минерал	м.
минералогия	ж.
миниатюрный	прил.
миро	ср.
мистификация	ж.
младенческий	прил.
младенчество	ср.
многолюдный	прил.
многочисленный	прил.
мозгляк	м. разг.-сниж.
молитвенный	прил.
молодечество	ср.
молозиво	ср.
молотьба	ж.
молочная	ж. разг.
молчаливость	ж.
монархия	ж.
монастырка	ж.
монастырские	мн.
монастырский	прил.
монахиня	ж.
монист	м.
монпансье	ср. нескл.
мордасы	мн. разг.-сниж.
морковь	ж.
москали	мн. разг.-сниж.
моток	м.
мохнатый	прил.
мразь	ж. разг.-сниж.
мраморный	прил.
мрачность	ж.
мстительный	прил.
мудрая	ж. разг.
мужицкий	прил. разг.-сниж.
мужичий	прил. разг.-сниж.
мужичина	м. разг.-сниж.
мурашка	ж. разг.-сниж.
мученичество	ср.
мушкет	м.
мыслящий	прил.
мясистый	прил.
наблюдательность	ж.
нагайка	ж.
наговор	м. разг.
нагота	ж.
надругательство	ср.
наезд	м.
названый	прил.
наидобрейший	прил.
наидостойнейший	прил.
наклонный	прил.
наплыв	м.
напой	м.
напор	м.
напраслина	ж. разг.
напуганный	прил. разг.
напутствие	ср.
напыщенный	прил.
нарзан	м.
народушка	м. разг.
нарядность	ж.
насекомые	мн.
наставница	ж.
настилка	ж.
настойка	ж.
нательный	прил.
натянутость	ж.
научение	ср. разг.
нахлебник	м.
нахлебница	ж.
находка	ж.
небожитель	м.
неверность	ж.
невидальщина	ж. разг.-сниж.
невод	м.
невозмутимый	прил.
невольник	м.
неволя	ж.
негодник	м. разг.
негромкий	прил.
недвижимое	ср. разг.
недобор	м.
недогадливый	прил.
недолгий	прил.
недоросль	м.
недоступное	ср. разг.
недоступность	ж.
неживой	прил.
нежилой	прил.
нежненький	прил. разг.
незаметный	прил.
незамеченный	прил.
нездоровый	прил.
незначащий	прил.
незримый	прил.
неизвестность	ж.
неизменность	ж.
неизменный	прил.
неизмеримый	прил.
неимение	ср.
неконченный	прил. разг.
некрасивость	ж.
некрашеный	прил.
нелюдимый	прил.
немолодой	прил.
немудрый	прил. разг.
немыслимый	прил.
ненастный	прил.
ненаходчивость	ж.
ненормальность	ж.
ненужность	ж.
необъяснимый	прил.
неопытность	ж.
непередаваемый	прил.
непобедимый	прил.
неповинный	прил.
неповоротливый	прил.
непозволительный	прил.
непокорность	ж.
непомерный	прил.
непонятливый	прил.
непонятный	прил.
непорочный	прил.
непослушание	ср.
непостоянный	прил.
непостоянство	ср.
непохожий	прил.
непреклонный	прил.
непреложный	прил.
непреодолимый	прил.
неприличность	ж.
непримиримый	прил.
непроницаемый	прил.
нерадение	ср.
нерадивая	ж. разг.
неразлучный	прил.
нерасположение	ср.
неровность	ж.
неровный	прил.
неряха	м. и ж.
несбыточное	ср. разг.
несессер	м.
несказанный	прил.
нескончаемый	прил.
несомненный	прил.
несообразный	прил.
неспособность	ж.
неспособный	прил.
несправедливый	прил.
нестройный	прил.
неторопливый	прил.
нетрезвый	прил.
неуверенность	ж.
неудобство	ср.
неуловимый	прил.
неумелость	ж.
неустанный	прил.
неустрашимый	прил.
неучтивость	ж.
неучтивый	прил.
нечестный	прил.
нечистота	ж.
нечистоты	мн.
неясность	ж.
ниточка	ж. разг.
нитяный	прил.
нищенство	ср.
новобрачные	мн.
ноготь	м.
нотабене	ср. нескл.
нянечка	ж. разг.
обдуманность	ж.
обеспеченность	ж.
обессиленный	прил.
обилие	ср.
обильный	прил.
облачный	прил.
обманщица	ж.
обмен	м.
обнаружение	ср.
обноски	мн. разг.
обод	м.
обожание	ср.
обой	м.
обоняние	ср.
оброчный	прил.
обтирка	ж.
обувь	ж.
общеармейский	прил.
овальный	прил.
овощи	мн.
овощной	прил.
оглавление	ср.
огласка	ж.
огневой	прил.
оговор	м.
односторонний	прил.
однотонный	прил.
одутловатый	прил.
окаменелость	ж.
оковы	мн.
оконце	ср. разг.
окорок	м.
окраска	ж.
окунь	м.
омрачение	ср.
опекун	м.
опера	ж.
операция	ж.
оппонент	м.
определяющий	прил.
опровержение	ср.
опрос	м.
оптический	прил.
организация	ж.
орешки	мн. разг.
осадок	м.
осек	м.
осетины	мн.
осколок	м.
ослабление	ср.
ослабленный	прил.
ослик	м. разг.
осложнение	ср.
осматривание	ср.
особливый	прил. разг.-сниж.
осокорь	м.
осуждение	ср.
осы	мн.
отбив	м.
отверделость	ж.
отвес	м.
отврат	м. разг.-сниж.
отзвук	м.
откат	м.
откормленный	прил.
отпертой	прил. разг.
отпущение	ср.
отрепье	ср.
отсечение	ср.
отсталость	ж.
отстой	м.
оттоманка	ж.
отупение	ср.
отчуждение	ср.
отъединение	ср.
офицерство	ср.
официант	м.
охват	м.
очерет	м.
очерченный	прил.
падающий	прил.
пазуха	ж.
пайщик	м.
пакетик	м. разг.
палаццо	ср. нескл.
палитра	ж.
пальба	ж.
пальтецо	ср. разг.
пальтишко	ср. разг.
памятный	прил.
панический	прил.
папироска	ж. разг.
папоротник	м.
парадная	ж. разг.
парижский	прил.
пародия	ж.
парча	ж.
пастухов	прил. разг.
пастушки	мн.
патент	м.
патлы	мн. разг.-сниж.
патологический	прил.
патриот	м.
паут	м. местн.
пахарь	м.
пахучий	прил.
пашня	ж.
пегашка	ж. разг.
пегий	прил.
пепелище	ср.
первенец	м.
перебранка	ж.
перевал	м.
перевозка	ж.
передник	м.
переложение	ср.
переменчивость	ж.
перемещение	ср.
переносье	ср.
переполненный	прил.
переработка	ж.
перехват	м.
периптер	м.
пернатые	мн. разг.
перочинный	прил.
петушки	мн. разг.
пианист	м.
пика	ж.
пикантное	ср. разг.
пирке	ср. нескл. разг.
пирушка	ж. разг.
пиршество	ср.
писанный	прил.
писарский	прил.
писательница	ж.
пискливый	прил.
питейный	прил.
пищеварение	ср.
плавание	ср.
платан	м.
плевок	м.
плесень	ж.
плитка	ж.
плодородие	ср.
плот	м.
площадной	прил. разг.
плутни	мн. разг.
плутовство	м.
плюшевый	прил.
плющ	м.
пляс	м. разг.
пляска	ж.
плясун	м.
победитель	м.
побрякушки	мн.
повадка	ж. разг.
повелительное	прил.
поверье	ср.
повествование	ср.
повестка	ж.
повязочка	ж. разг.
погань	ж. разг.
погибающий	м.
пограничный	прил.
погром	м.
подавальщик	м. разг.
подающий	м.
подвесок	м.
подговор	м.
поддельный	прил.
подзеркальник	м.
подкладка	ж.
подколенки	мн. разг.
подозреваемый	м.
подорожная	ж.
подробность	ж.
подрядчик	м.
подхват	м.
пожертвование	ср.
пожива	ж. разг.
поживший	прил.
позорище	ср.
позумент	м.
покатость	ж.
покатый	прил.
покачивание	ср.
покашливание	ср.
покаянный	прил.
покер	м.
поклонник	м.
покровительственный	прил.
полдороги	ж.
полено	ср.
полишинель	м.
полнолуние	ср.
полосатый	прил.
полубольная	ж. разг.
полугодовой	прил.
получеловек	м.
полцарства	ср.
полымя	ср. нар.-поэт.
пользование	ср.
полюбовник	м. разг.-сниж.
полюс	м.
поляна	ж.
помада	ж.
поместительный	прил.
поминовение	ср.
поминок	м.
помощница	ж.
понятливость	ж.
попирание	ср.
попрошайка	м. и ж. разг.
популярность	ж.
попуститель	м.
поразительный	прил.
порицание	ср.
порожний	прил. разг.
пороховой	прил.
портвейн	м.
портки	мн. разг.-сниж.
поругание	ср.
порука	ж.
порфир	м.
порча	ж.
порывчатый	прил. разг.
посев	м.
посланная	ж. разг.
посланница	ж.
последующий	прил.
посрамление	ср.
посредник	м.
постановка	ж.
потасовка	ж.
потир	м.
потный	прил.
потребление	ср.
потчевание	ср.
похоронный	прил.
почерневший	прил.
почки	мн.
пошиб	м.
правдивость	ж.
правдоподобие	ср.
праведник	м.
праведница	ж.
прадед	м.
прадедов	прил.
прадедовский	прил.
прадеды	мн.
празднование	ср.
праздношатайка	м. и ж. разг.
прародитель	м.
пращур	м.
преглубокий	прил.
преграда	ж.
преднамеренность	ж.
преднамеренный	прил.
предопределение	ср.
предплечье	ср.
предпоследний	прил.
предстоящее	ср.
предубеждение	ср.
предупреждение	ср.
предусмотрительность	ж.
презлой	прил.
прелюбезный	прил.
премиленький	прил. разг.
пренизкий	прил.
прения	мн.
преподаватель	м.
преподобный	прил.
препочтенный	прил.
препровождение	ср.
пресмешной	прил.
пресный	прил.
престрашный	прил.
преступное	ср. разг.
пресыщенный	прил.
претендент	м.
преувеличенный	прил.
прехрабрый	прил.
прибежище	ср.
приблизительный	прил.
прибыль	ж.
привал	м.
привоз	м.
привычный	прил.
пригласительный	прил.
приготовительный	прил.
придирчивость	ж.
придумочка	ж. разг.
призванный	м.
признательность	ж.
признательный	прил.
призывный	прил.
прикладывание	ср.
прилежание	ср.
приманка	ж.
примечание	ср.
примиритель	м. разг.
принятый	прил.
припарки	мн.
припев	м.
приправа	ж.
присед	м.
присест	м.
пристяжной	прил.
приток	м.
приумножение	ср.
причетник	м.
пробный	прил.
провизия	ж.
провинность	ж. разг.
проводы	мн.
провоз	м.
провозглашение	ср.
прогрессивный	прил.
прогул	м.
продавец	м.
продолжительность	ж.
продукт	м.
проезжающий	м.
прожитие	ср.
прозаичность	ж.
прозорливый	прил.
прозрачность	ж.
прозябание	ср. разг.
происки	мн.
пройдоха	м. и ж. разг.-сниж.
прокламация	ж.
прокурорша	ж. разг.
пролив	м.
проливной	прил.
прометей	м.
промол	м.
промышленность	ж.
промышленный	прил.
проникновенный	прил.
пронос	м.
пропаганда	ж.
пропащая	ж. разг.
прописи	мн.
пропойца	м. и ж. разг.
прорубь	ж.
прославленный	прил.
простак	м.
простенький	прил. разг.
простонародный	прил.
пространный	прил.
протеже	м. и ж. нескл.
противозаконный	прил.
протоиерей	м.
профессия	ж.
прохвост	м. разг.-сниж.
прочность	ж.
прыгуны	мн.
псалом	м.
псалтирь	ж.
псалтырь	м. и ж.
псарня	ж.
птенчик	м. разг.
публицист	м.
пугающий	прил.
пуговка	ж. разг.
пуп	м. разг.
пурпур	м.
пуховик	м.
пушечка	ж. разг.
пшеница	ж.
пшено	ср.
пышность	ж.
пятерик	м.
пятидесятилетний	прил.
пятнадцатилетний	прил.
равелин	м.
разборка	ж. разг.
развитый	прил.
разгульный	прил.
раздвоение	ср.
раздел	м.
раздробленный	прил.
разлив	м.
разлучница	ж. разг.
разноголосый	прил.
разнообразный	прил.
разносчик	м.
разночинец	м.
разор	м. разг.-сниж.
райский	прил.
рака	ж.
раковина	ж.
рама	ж.
ранг	м.
распивочная	ж. разг.
расплата	ж.
расположенный	прил.
распор	м.
распорядитель	м.
распорядок	м.
распущенный	прил.
рассказчица	ж.
расслабление	ср.
рассмотрение	ср.
расспрос	м.
растерзанный	прил.
растление	ср.
растопленный	прил.
растопыря	м. и ж. разг.-сниж.
расточитель	м.
расширение	ср.
ратник	м.
реакционер	м.
ребятки	мн. разг.
ребячество	ср. разг.
реванш	м.
регулярность	ж.
редис	м.
резеда	ж.
резерв	м.
резня	ж.
религиозность	ж.
религиозный	прил.
ремни	мн.
репертуар	м.
ресница	ж.
ресторанчик	м. разг.
ретроградка	ж. разг.
ретроградство	ср.
речонка	ж. разг.
решающий	прил.
ржа	ж. разг.-сниж.
рискованный	прил.
ровесник	м.
родимец	м. местн.
родимчик	м. разг.
родинка	ж.
родоначальник	м.
родословная	ж.
роды	мн.
розыск	м.
рол	м.
романический	прил.
роскошный	прил.
россказни	мн. разг.
ростки	мн.
рубиновый	прил.
ругань	ж.
рудник	м.
рудый	прил. местн.
ружейный	прил.
ружьишко	ср. разг.
румяненький	прил. разг.
русалка	ж.
русый	прил.
ручища	ж. разг.
ручной	прил.
рыбный	прил.
рыцарский	прил.
рябая	ж.
саврасая	ж. разг.
сакля	ж.
саламата	ж.
самец	м.
самодур	м. разг.
самонадеянный	прил.
самоощущение	ср.
самоуверенный	прил.
самоуправление	ср.
саночки	мн. разг.
сапожишки	мн. разг.
сарацины	мн.
саркофаг	м.
сатира	ж.
сахаровар	м.
сбавка	ж. разг.
сбруя	ж.
свара	ж. разг.-сниж.
светильник	м.
светляк	м.
светоносный	прил.
светопреставление	ср.
свинтус	м. разг.
свисток	м.
свиток	м.
своенравие	ср.
своеобразный	прил.
святитель	м.
сделка	ж.
себялюбие	ср.
сегодняшнее	ср.
секретарша	ж. разг.
сектант	м.
селезень	м.
сельдь	ж.
семидесятилетний	прил.
семилетний	прил.
семинария	ж.
сенат	м.
сентябрьский	прил.
сера	ж.
сердчишко	ср. разг.
серебристый	прил.
серенький	прил. разг.
сероватый	прил.
сет	м.
сжатие	ср.
сигарка	ж. разг.
сиделка	ж.
сидор	м. разг.-сниж.
силлогизм	м.
сильфиды	мн.
сирен	м.
сиреневый	прил.
сироточка	м. и ж. разг.
ситце	ср. разг.
скарлатина	ж.
скачка	ж.
скачущий	прил.
сквернословие	ср.
скиния	ж.
складный	прил. разг.
склонный	прил.
скопцы	мн.
скороговорка	ж.
скрижали	мн.
скряга	м. и ж.
скудный	прил.
скумбрия	ж.
слабенький	прил. разг.
слабодушие	ср. разг.
слабосилие	ср. разг.
славолюбие	ср.
сладковатый	прил.
сладострастный	прил.
следование	ср.
слепота	ж.
служака	ж. разг.
слышный	прил.
слюнка	ж. разг.
смена	ж.
смертность	ж.
смешливый	прил.
смиренник	м. разг.
смоляной	прил.
сморщенный	прил.
смрадный	прил.
снегирь	м.
снеговой	прил.
снежный	прил.
снисходительность	ж.
сноровка	ж.
сноха	ж.
собаченька	ж. разг.
соблазнитель	м.
собственноручный	прил.
совершение	ср.
совестливый	прил.
совокупность	ж.
согбенный	прил.
содержанка	ж.
сожительство	ср.
созерцатель	м.
соколиный	прил.
сокровенное	ср.
сокрушение	ср.
солон	прил. разг.
сообщество	ср.
сообщник	м.
соответствие	ср.
соответствующий	прил.
сорвиголова	м. и ж. разг.
соревнование	ср.
сорокалетний	прил.
сорт	м.
соседушка	м. и ж. разг.
сосиски	мн.
сосок	м.
состоятельный	прил.
спазма	ж.
спайка	ж.
спаржа	ж.
спекулянт	м.
спесивый	прил.
спесь	ж.
специалист	м.
спорный	прил.
справка	ж.
спутанный	прил.
ставня	ж.
стамеска	ж.
старка	ж.
старушечий	прил.
старушоночка	ж. разг.
старческий	прил.
статейка	ж. разг.
стек	м.
стечение	ср.
стирка	ж.
стожар	м. местн.
стойкость	ж.
столбец	м.
стонущий	прил.
сторонник	м.
стоянка	ж.
страдалец	м.
страдальческий	прил.
страж	м.
стража	ж.
странники	мн.
страшилище	ср. разг.
стремительность	ж.
струнные	мн.
стручок	м.
студенческий	прил.
судки	мн.
сумасбродство	ср. разг.
супостат	м.
сургуч	м.
сутуловатый	прил.
сутяга	м. и ж. разг.
суфле	ср. нескл.
сухопарый	прил. разг.
сучок	м. разг.
существенное	ср.
сходни	мн.
схожий	прил. разг.
сыновний	прил.
сытенький	прил. разг.
табунщик	м.
таган	м.
талмуд	м.
таможня	ж.
танцевальный	прил.
творческий	прил.
театральность	ж.
тезис	м.
телеграф	м.
телохранитель	м.
телушка	ж. разг.
тельце	ср. разг.
темперамент	м.
температура	ж.
тенденция	ж.
теорийка	ж. разг.
терзание	ср.
терпкий	прил.
тесовый	прил.
техник	м.
тирания	ж.
тиранка	ж. разг.
тиранство	ср.
тиф	м.
тихоня	м. и ж. разг.
тление	ср.
толстенький	прил. разг.
толстушка	ж. разг.
торги	мн.
торчащий	прил.
трактат	м.
требник	м.
требуемый	прил.
тревожность	ж.
трезвон	м.
трезвость	ж.
трения	мн.
третьестепенный	прил.
треугольный	прил.
трещание	ср. разг.
трещина	ж.
трещотки	мн.
тризна	ж.
трог	м.
тройной	прил.
трок	м.
трон	м.
тропа	ж.
трудовой	прил.
трусишки	мн. разг.
трясение	ср.
трясущийся	прил.
тулупчик	м.
туннель	м.
турник	м.
тучка	ж. разг.
тысячелетия	мн.
тяготы	мн. разг.
убогая	ж.
убой	м.
убыль	ж.
увеселительный	прил.
увольнение	ср.
удостоверение	ср.
удочка	ж.
узость	ж.
укладка	ж.
укрепление	ср.
укромный	прил.
укротитель	м.
укрыватель	м. разг.
уксус	м.
укушенный	прил.
уланы	мн.
уличная	ж. разг.
ультрамонтанство	ср.
умение	ср.
умеренность	ж.
умершая	ж.
умножение	ср.
упадок	м.
уполовник	м. местн.
упругость	ж.
упущение	ср.
уродливость	ж.
урожайный	прил.
уроженец	м.
усищи	мн. разг.
успокоение	ср.
устремление	ср.
устрица	ж.
уступ	м.
усыпление	ср.
утешительный	прил.
утиральник	м. местн.
утопающий	м.
учтивый	прил.
фагот	м.
факелы	мн.
фал	м.
фамильный	прил.
фантасмагория	ж.
фантаст	м.
фанты	мн.
фанфарон	м. разг.
фанфаронишка	м. разг.
фарс	м.
фатум	м.
феллах	м.
фельетон	м.
фигляр	м.
фила	ж.
финальный	прил.
фиолетовый	прил.
фойе	ср. нескл.
формальности	мн.
форточка	ж.
фотографический	прил.
фронтон	м.
фуфайка	ж.
хаджи	м. нескл.
халатик	м. разг.
ханжество	ср.
характерность	ж.
харч	м. разг.-сниж.
хвастливый	прил.
хворостина	ж.
хит	м.
хламида	ж.
хлебное	ср.
хлопчик	м. разг.
ходячая	ж. разг.
хозяйкин	прил.
холодноватый	прил. разг.
храбрая	ж.
храбрец	м.
хрестоматия	ж.
хрипение	ср.
хромоножка	м. и ж. разг.
художественный	прил.
художница	ж.
худосочный	прил.
худощавая	ж.
худшее	ср.
хула	ж.
царевна	ж.
царствование	ср.
цветочек	м. разг.
цезарь	м.
целование	ср.
целомудренность	ж.
ценз	м.
ценность	ж.
циничный	прил.
циферблат	м.
цыганский	прил.
чалма	ж.
чан	м.
частность	ж.
частый	прил.
черви	мн.
червячок	м. разг.
черен	м. местн.
черепаха	ж.
черепаховый	прил.
черкес	м.
чернобровая	ж.
черновой	прил.
чернослив	м.
честнейшая	ж. разг.
честолюбец	м.
честолюбивый	прил.
чеченцы	мн.
чиновничество	ср.
чиновничишка	м. разг.
чирей	м. разг.
чистокровный	прил.
чрезмерный	прил.
чудотворец	м.
чуланчик	м. разг.
чулочный	прил.
чуньки	мн.
чушь	ж. разг.
шагистика	ж.
шаловливый	прил.
шантаж	м.
шарлатан	м.
шарлатанство	ср.
шарфик	м. разг.
шахматы	мн.
швабский	прил.
швед	м.
шведский	прил.
швец	м. местн.
швея	ж.
шевеление	ср.
шипение	ср.
шиповник	м.
ширма	ж.
широкоплечий	прил.
шланг	м.
шлюз	м.
шлюха	ж.
шмель	м.
шнур	м.
шнурок	м.
штанишки	мн. разг.
штифтик	м. разг.
штос	м.
штраф	м.
штрих	м.
шумящий	прил.
шуточка	ж. разг.
шушера	ж.
щеголеватый	прил.
щедроты	мн.
щедрый	прил.
щеночек	м. разг.
эгоцентризм	м.
экзальтация	ж.
экстракт	м.
элегический	прил.
эмигрант	м.
энтузиастка	ж.
эпилептик	м.
эпитет	м.
эстетический	прил.
ювелир	м.
юношеский	прил.
ют	м.
яблочный	прил.
яма	ж.
ямщиков	прил. разг.
янычар	м.
японский	прил.
японцы	мн.
ярка	ж.
ясеневый	прил.
ясноокая	ж. нар.-поэт.
ящичек	м. разг.
абажур	м.
аббатство	ср.
абиссинский	прил.
абрис	м.
абсолют	м.
авантюрист	м.
авары	мн.
августовский	прил.
австралийский	прил.
австралийцы	мн.
австриец	м.
австрийцы	мн.
автобиография	ж.
автограф	м.
авторские	мн. разг.
агат	м.
агония	ж.
адат	м.
администрация	ж.
адский	прил.
адъюнкт	м.
азартный	прил.
азбука	ж.
азиаты	мн.
азям	м. местн.
аисты	мн.
академик	м.
академический	прил.
академия	ж.
акафист	м.
акация	ж.
акварелист	м.
акварель	ж.
аккомпаниатор	м.
акр	м.
акробат	м.
активность	ж.
акулы	мн.
акушерка	ж.
акцизный	прил.
алгебра	ж.
алебарда	ж.
алебастр	м.
аллегорический	прил.
алмаз	м.
алчный	прил.
альков	м.
альманах	м.
амбарчик	м. разг.
амбициозность	ж.
амбра	ж.
американский	прил.
аметист	м.
амнистия	ж.
амфитеатр	м.
аналой	м.
ананасный	прил.
анатомия	ж.
анахронизм	м.
англоман	м.
анисовая	ж. разг.
античный	прил.
антропофагия	ж.
аперитив	м.
аполог	м.
апофеоз	м.
апрельский	прил.
аптека	ж.
арабский	прил.
арамеи	мн.
аргентинка	ж.
арендатор	м.
ареопаг	м.
ариец	м.
аристократический	прил.
аристократка	ж.
аркада	ж.
армеец	м.
арсенал	м.
артельный	прил.
артиллерист	м.
архалук	м.
архангельский	прил.
архипелаг	м.
архитектура	ж.
архитектурный	прил.
арча	ж.
аспидный	прил.
ассигнационный	прил.
ассигнация	ж.
ассистент	м.
асфальт	м.
атака	ж.
атаманский	прил.
атрибуты	мн.
аукцион	м.
аукционист	м.
аффект	м.
аффектация	ж.
бабенька	ж. разг.
бабушкин	прил.
баз	м. местн.
байдара	ж. местн.
бакалейный	прил.
баклажка	ж. разг.
балахон	м.
балет	м.
балетный	прил.
бананы	мн. разг.
банда	ж.
банкрот	м.
банька	ж. разг.
баня	ж.
барашки	мн. разг.
барк	м.
барство	ср.
барсук	м.
бархатистость	ж.
барчонок	м. разг.
баск	м.
баснописец	м.
басовый	прил.
басок	м. разг.
бассейн	м.
басы	мн.
батрачка	ж.
бахвал	м. разг.
бахвальство	ср. разг.
бацилла	ж.
бдение	ср.
беглянка	ж.
бегуны	мн.
бедлам	м. разг.
бедняжечка	м. и ж. разг.
бедовый	прил. разг.
бедуин	м.
безалаберщина	ж. разг.
безбожный	прил.
безбрачие	ср.
безветренный	прил.
безвинная	ж. разг.
безвозвратное	ср.
бездействие	ср.
бездетный	прил.
бездеятельность	ж.
бездонный	прил.
беззаветный	прил.
беззаконный	прил.
беззащитность	ж.
беззубый	прил.
безлюдье	ср.
безмерный	прил.
безмятежный	прил.
безоружный	прил.
безответность	ж.
безошибочный	прил.
безразличие	ср.
безрассудный	прил.
безрыбье	ср.
безудержный	прил.
безучастие	ср.
безыскусственный	прил.
белоголовый	прил.
беломордый	прил.
белоснежный	прил.
бельведер	м.
бельевая	ж.
бельецо	ср. разг.
бельмо	ср.
бенедиктин	м.
бенефис	м.
бенуар	м.
бердана	ж. разг.
бесноватая	ж. разг.
беспамятный	прил. разг.
беспардонный	прил. разг.
беспорядочность	ж.
беспредельность	ж.
беспрепятственный	прил.
беспрестанный	прил.
беспристрастный	прил.
бесприютная	ж. разг.
бесприютность	ж.
беспутник	м. разг.-сниж.
беспутство	ср.
бесславный	прил.
бессловесность	ж.
бессловесные	мн. разг.
бессмертная	ж. разг.
бессмыслие	ср.
бессовестность	ж.
бессознательность	ж.
бесстрашие	ср.
бесстыжая	ж. разг.
бестолковость	ж.
бестолковщина	ж. разг.
бесформенный	прил.
бесхарактерность	ж.
бесцеремонный	прил.
бесчеловечность	ж.
бесчеловечный	прил.
бесчувственность	ж.
бесчувствие	ср.
бешмет	м.
библиография	ж.
библиотекарь	м.
бивак	м.
бивачный	прил.
биограф	м.
бирюза	ж.
бирюзовый	прил.
бисерный	прил.
бисквиты	мн.
битва	ж.
благоверная	ж. разг.
благовидный	прил.
благовонный	прил.
благовоспитанный	прил.
благодатный	прил.
благодушный	прил.
благообразный	прил.
благопристойность	ж.
благотворительность	ж.
благотворный	прил.
благоуханный	прил.
благочестие	ср.
бланманже	ср. нескл.
бледненький	прил. разг.
бледноватый	прил.
близорукость	ж.
близь	ж. разг.
блинцы	мн. разг.
блудливый	прил. разг.-сниж.
блюститель	м.
бобр	м.
богадельный	прил.
богатырский	прил.
богачка	ж. разг.
богомолка	ж.
богослужение	ср.
богохульник	м. разг.
бодяк	м.
божеский	прил.
божественность	ж.
болезненность	ж.
болонка	ж.
болотистый	прил.
болотный	прил.
болотце	ср. разг.
большущий	прил. разг.
бордель	м. разг.-сниж.
бормотание	ср.
боровинка	ж.
ботва	ж.
ботинок	м.
ботиночки	мн. разг.
боты	мн.
бочковатость	ж.
боярство	ср.
боярышник	м.
брага	ж.
браслеты	мн.
братоубийство	ср.
браунинг	м.
бревенчатый	прил.
брелок	м.
бретонец	м.
брехня	ж. разг.-сниж.
брешь	ж.
бригантина	ж.
бриллиантовый	прил.
британец	м.
бродяжка	м. и ж. разг.
бром	м.
брус	м.
брусника	ж.
брыкливость	ж. разг.
брюхастый	прил. разг.-сниж.
брюхатая	прил. разг.-сниж.
бряцание	ср.
бугристый	прил.
будний	прил.
буйвол	м.
буки	ср. нескл.
букинист	м.
булавка	ж.
булатный	прил.
бумагомарака	м. и ж. разг.
буравчик	м. разг.
буран	м.
буржуазный	прил.
буриме	ср. нескл.
буркалы	мн. разг.-сниж.
бурлак	м.
бурливый	прил.
бус	м. местн.
бусы	мн.
бут	м.
бутафорский	прил.
бутылочка	ж. разг.
буффон	м.
бухарский	прил.
бухгалтер	м.
бушмен	м.
буянство	ср. разг.
быдло	ср.
былое	ср.
быстроходный	прил.
бычий	прил.
важничание	ср. разг.
вакханка	ж.
вальтрап	м.
вампир	м.
ваниль	ж.
ванты	мн.
варево	ср. разг.-сниж.
варежки	мн.
вариант	м.
вариации	мн.
ватный	прил.
ваяние	ср.
ввод	м.
вводный	прил.
вдовство	ср.
вдумчивость	ж.
вдыхание	ср.
веда	ж.
ведьмак	м. местн.
веко	ср.
великомученический	прил.
великонек	прил. нар.-поэт.
великорослый	прил.
вена	ж.
веничек	м. разг.
венчальный	прил.
верблюжий	прил.
веред	м. разг.-сниж.
верзила	м. и ж. разг.
вермут	м.
версификация	ж.
верстовой	прил.
вертопрах	м. разг.
вертун	м.
вертящийся	прил.
вест	м.
ветеринарный	прил.
ветерочек	м. разг.
ветошь	ж.
ветхозаветный	прил.
вехи	мн.
вечеринка	ж. разг.
вещее	ср. разг.-сниж.
вещество	ср.
вещий	прил.
вещунья	ж. разг.-сниж.
взбалмошный	прил. разг.
взвар	м. местн.
взлом	м.
взломщик	м.
взморье	ср.
взмыв	м.
взрослая	ж. разг.
взыскание	ср.
взыскательный	прил.
вибрирующий	прил.
видимость	ж.
визитный	прил.
виконт	м.
вилла	ж.
вилы	мн.
винище	ср. разг.-сниж.
винница	ж.
виноградник	м.
виноградный	прил.
винокурня	ж.
висячий	прил.
вития	м.
витрина	ж.
витязь	м.
вихрастый	прил. разг.
вишенка	ж. разг.
вишенник	м.
вкрадчивый	прил.
влага	ж.
владелица	ж.
влажность	ж.
властитель	м.
власяница	ж.
внезапность	ж.
внешнее	ср. разг.
внучата	мн. разг.
внучек	м. разг.
внученька	ж. разг.
внушительный	прил.
водевильный	прил.
водный	прил.
водовоз	м.
водоворот	м.
водопой	м.
водосточный	прил.
водочка	ж. разг.
военачальник	м.
вожделение	ср.
возведение	ср.
возвышение	ср.
воздействие	ср.
возик	м. разг.
возмутитель	м.
возрождение	ср.
возчик	м.
воинский	прил.
войлочек	м. разг.
войлочный	прил.
войсковой	прил.
волга	ж. разг.
волнорез	м.
волосатый	прил.
волость	ж.
волчонок	м.
волшебница	ж.
воробьиные	мн.
воробьиный	прил.
ворожея	ж.
ворожка	ж. местн.
воротный	прил.
ворох	м.
ворс	м.
ворчун	м. разг.
ворчунья	ж. разг.
восемнадцатилетний	прил.
воскреситель	м.
воспитанница	ж.
воспитательница	ж.
восприимчивый	прил.
восхваление	ср.
восхитительный	прил.
восходящий	прил.
восьмилетний	прил.
восьмиугольник	м.
вотчина	ж.
впуск	м.
враждебность	ж.
вращающийся	прил.
вредный	прил.
всезнание	ср.
вселенский	прил.
всемилостивейший	м.
всемогущий	прил.
всепоглощающий	прил.
всепрощение	ср.
всесильный	прил.
всесторонний	прил.
вскрик	м.
всплески	мн.
вспыльчивость	ж.
вспыльчивый	прил.
вспых	м. разг.
вставка	ж.
всхлип	м. разг.
всходы	мн.
всячина	ж. разг.
втора	ж.
второстепенность	ж.
второстепенный	прил.
втягивание	ср.
вульгарный	прил.
вшивость	ж.
выброс	м.
вывес	м. разг.
выдел	м.
выдержанность	ж.
выдра	ж.
выездка	ж.
выемка	ж.
выжженный	прил.
выжимки	мн.
выкрик	м.
выкуп	м.
вылет	м.
вылощенный	прил.
вымирание	ср.
выпивала	м. и ж. разг.-сниж.
выпивка	ж. разг.
выпивший	м. разг.
выпуклость	ж.
выпушка	ж.
выраженьице	ср. разг.
выразитель	м.
выразительность	ж.
выразительный	прил.
выродок	м.
высокопарный	прил.
высокость	ж.
высочество	ср.
выступающая	ж. разг.
выходная	ж. разг.
выцветший	прил.
вычет	м.
вышесказанный	прил.
вышибала	м. разг.-сниж.
вышивка	ж.
вьюк	м.
вязаный	прил.
гавана	ж. разг.
гавот	м.
гады	мн. разг.
газетный	прил.
газон	м.
галантность	ж.
галун	м.
галчонок	м.
гамак	м.
гаммы	мн.
гараж	м.
гарантия	ж.
гарда	ж.
гарем	м.
гармонический	прил.
гарнитур	м.
гарус	м.
генералиссимус	м.
геодезист	м.
геометрия	ж.
герб	м.
германец	м. разг.-сниж.
германский	прил.
героическое	ср. разг.
герцогство	ср.
гетры	мн.
гибельный	прил. разг.
гигант	м.
гидравлический	прил.
гиены	мн.
гильотина	ж.
гимназистик	м. разг.
гимназия	ж.
гимнаст	м.
гимнастика	ж.
гимнастка	ж.
гипертрофия	ж.
гипнотизирующий	прил.
гипюр	м.
гирлянда	ж.
гитана	ж.
глазищи	мн. разг.
глазной	прил.
глинистый	прил.
глубокомыслие	ср.
глумление	ср.
глухонемой	прил.
глухота	ж.
глянцевитый	прил.
гневливый	прил. разг.
гнедая	ж. разг.
гнойный	прил.
гном	м.
година	ж.
годичный	прил.
годный	прил.
годовщина	ж.
годок	м. разг.
голгофа	ж.
голенастые	мн.
голенище	ср.
головешка	ж.
головщик	м.
голоштанник	м. разг.-сниж.
голубоглазый	прил.
гонг	м.
гондола	ж.
гонец	м.
гонитель	м.
горбина	ж.
горбоносый	прил. разг.
горбун	м.
гордец	м.
горилка	ж. разг.-сниж.
гористый	прил.
горлан	м.
горнило	ср.
горностай	м.
гороскоп	м.
гороховый	прил.
горошина	ж.
горсточка	ж. разг.
горчица	ж.
горчичный	прил.
горючее	ср.
горячечный	прил.
горящий	прил.
госпиталь	м.
госпитальный	прил.
господство	ср.
господствование	ср.
гостинчик	м. разг.
готовое	ср. разг.
граб	м.
градус	м.
гражданство	ср.
граммофон	м.
грациозный	прил.
гремучий	прил.
грешок	м. разг.
греющий	прил.
грибной	прил.
грива	ж.
гривенничек	м. разг.
грим	м.
грипп	м.
грозд	м.
грозды	мн.
грозовой	прил.
громадность	ж.
громила	м. разг.-сниж.
громкоговоритель	м.
громовой	прил.
громоздкий	прил.
грошовый	прил.
грубоватый	прил. разг.
грузило	ср.
грузинский	прил.
грузовой	прил.
группировка	ж.
грушка	ж. разг.
грязненький	прил. разг.
грязюка	ж. разг.
гульба	ж. разг.-сниж.
гулящая	ж. разг.
гуляющий	м. разг.
гуммиарабик	м.
гурда	ж.
гуртовщик	м.
гусли	мн.
гусыня	ж.
дальновидность	ж.
дальновидный	прил.
дантист	м.
дарвинизм	м.
дармоед	м. разг.
дармоедка	ж. разг.
даровитость	ж.
дарственная	ж.
дата	ж.
дачка	ж. разг.
дачный	прил.
двадцатилетие	ср.
движимое	ср.
двойка	ж.
двойственность	ж.
дворницкий	прил.
дворянка	ж.
дворянство	ср.
двугривенник	м. разг.
двугривенничек	м. разг.
двукратный	прил.
двуспальный	прил.
двухнедельный	прил.
двухсотлетие	ср.
двухсотлетний	прил.
дебаркадер	м.
девичник	м.
девчоночка	ж. разг.
девчурка	ж. разг.
девяностолетний	прил.
девятилетний	прил.
девятнадцатилетний	прил.
дедовский	прил.
дедушкин	прил.
деепричастие	ср.
дезинфекция	ж.
действенность	ж.
действующий	прил.
дек	м.
декабристы	мн.
декадент	м.
декадентство	ср.
декоративный	прил.
делание	ср.
деление	ср.
демикотон	м.
денежка	ж. разг.
дерзновение	ср.
дерюга	ж.
деспотка	ж. разг.
десятилетний	прил.
детишки	мн. разг.
детскость	ж.
детушки	мн. нар.-поэт.
дешевизна	ж. разг.
деятельный	прил.
джентльменский	прил.
джентльменство	ср.
джигитовка	ж.
диалектик	м.
диалог	м.
дивизионный	прил.
диез	м.
диковинка	ж. разг.
диковинный	прил. разг.
дилетант	м.
дилетантизм	м.
динамит	м.
дипломатический	прил.
директорский	прил.
диспут	м.
диссертация	ж.
дитятко	ср. разг.
дичина	ж. разг.
длинноногий	прил.
длиннополый	прил.
длиннорукий	прил.
длинноты	мн.
днище	ср.
добровольный	прил.
добротность	ж.
добывание	ср.
догадливость	ж.
догадливый	прил.
догмат	м.
дождичек	м. разг.
докторский	прил.
долговое	ср.
долговременный	прил.
долгота	ж.
должишки	мн. разг.-сниж.
доломан	м.
долонь	ж.
долото	ср.
домен	м.
домовый	прил.
доморощенный	прил.
домосед	м.
домохозяйка	ж.
донжуан	м.
донник	м.
донцы	мн. разг.
донышко	ср. разг.
донья	ж.
допотопный	прил.
допросчик	м.
дородность	ж.
досмотр	м.
доставка	ж.
доставление	ср.
достигнутый	прил.
дот	м.
дофин	м.
доходность	ж.
драгун	м.
драгунский	прил.
драдедам	м.
дражайшая	ж. разг.
драматург	м.
драпировка	ж.
дрема	ж.
дрессировка	ж.
дрессировщик	м.
дровяной	прил.
дрожечки	мн. разг.
дрок	м.
дротик	м.
дрофиные	мн.
дружелюбность	ж.
дружелюбный	прил.
дружественный	прил.
дружный	прил.
дрянненький	прил. разг.
дряхлость	ж.
дубинноголовая	ж. разг.
дубликат	м.
дуплет	м.
дуплистый	прил.
дурнота	ж. разг.
дутый	прил.
дымный	прил.
дымовой	прил.
дымок	м. разг.
дымчатый	прил.
дьяволица	ж. разг.-сниж.
дьявольщина	ж.
дюны	мн.
еврейка	ж.
египетский	прил.
египтяне	мн.
египтянин	м.
единодушный	прил.
единоутробный	прил.
единство	ср.
едкость	ж.
едок	м.
ежегодный	прил.
ежемесячный	прил.
еженедельный	прил.
ежечасный	прил.
ездок	м.
еловый	прил.
епитрахиль	ж.
естествоиспытатель	м.
жабы	мн.
жаворонок	м.
жалостливый	прил. разг.
жалостный	прил. разг.
жалюзи	мн. нескл.
жандармский	прил.
жаргон	м.
жарка	ж. разг.
жарки	мн. местн.
жасмин	м.
желанная	ж.
желающая	ж. разг.
желающий	м. разг.
железнодорожник	м.
железнодорожный	прил.
железняк	м.
желобок	м. разг.
желтоволосый	прил.
желудочный	прил.
жемчужный	прил.
женственное	ср. разг.
женственность	ж.
женственный	прил.
жернова	мн. разг.
жестикуляция	ж.
жестокосердие	ср.
жестянка	ж. разг.
живность	ж.
живописный	прил.
животворящий	прил.
жиденький	прил. разг.
жидкое	ср. разг.
жилетный	прил.
жим	м.
жираф	м.
жирок	м. разг.
жительство	ср.
житьецо	ср. разг.
жниво	ср. местн.
жнитво	ср. местн.
жница	ж.
жуликоватый	прил. разг.
жупа	ж.
журчание	ср.
жуткий	прил. разг.
заботливый	прил.
забывчивость	ж.
забывчивый	прил.
заваль	ж. разг.-сниж.
завербованный	м. разг.
завеса	ж.
завидный	прил.
завируха	ж. разг.-сниж.
зависимость	ж.
завистник	м.
завлекательный	прил. разг.
завоевание	ср.
завоевания	мн.
завязь	ж.
загвоздка	ж. разг.
заглохлый	прил. разг.-сниж.
загоревший	прил.
загород	м. разг.
загородка	ж. разг.
загородный	прил.
заготовление	ср.
загривок	м.
задавленность	ж.
задавленный	прил. разг.-сниж.
заданный	прил.
задатки	мн.
задворок	м. местн.
задержанная	ж.
задира	м. и ж. разг.
задирала	м. и ж. разг.-сниж.
заздравный	прил.
заика	м. и ж.
заискивание	ср.
закавыка	ж. разг.
закладная	ж.
заключительный	прил.
заклятый	прил.
заколдованный	прил.
законодатель	м.
закоптелый	прил.
закоснелость	ж.
закоулок	м.
закрывание	ср.
закупка	ж.
закупоренный	прил.
закут	м.
закута	ж. местн.
залежалый	прил. разг.
заливчатый	прил.
залихватский	прил. разг.
замета	ж. разг.
замечаньице	ср. разг.
замирание	ср.
замшевый	прил.
замысловатый	прил.
занимательность	ж.
заоблачный	прил.
западник	м.
западня	ж.
запальчивость	ж.
запаска	ж. разг.
заплатка	ж. разг.
заплечный	прил.
запоздавший	прил.
запоздалый	прил.
заполненный	прил.
запонка	ж.
запорожский	прил.
запрестольный	прил.
запретное	ср. разг.
запросы	мн.
запруда	ж.
запястье	ср.
зарвавшийся	прил.
зарождение	ср.
зарок	м.
засада	ж.
засвидетельствование	ср.
заскорузлый	прил. разг.
заслонка	ж.
застава	ж.
застенчивость	ж.
заступа	ж. разг.-сниж.
заступник	м.
застывший	прил.
затейник	м. разг.
затейница	ж. разг.
затонувший	прил.
затруднительный	прил.
заутреня	ж.
захватывающий	прил. разг.
захолустный	прил.
зацеп	м.
защитница	ж.
звенящий	прил.
звериный	прил.
зверолов	м.
звероподобный	прил.
зверство	ср.
звякание	ср.
здоровьице	ср. разг.
здравомыслие	ср.
здравомыслящий	прил.
зевака	м. и ж. разг.
зевок	м.
зеленя	мн. местн.
землевладение	ср.
земледелие	ср.
землячка	ж.
земство	ср.
зеркальность	ж.
зерцала	мн.
зипунишко	м. разг.
зияющий	прил.
злак	м.
златоуст	м.
зловонный	прил.
злодейский	прил.
злопамятность	ж.
злополучный	прил.
злословие	ср.
злосчастный	прил.
змеев	прил. нар.-поэт.
змеиный	прил.
значимость	ж.
значительность	ж.
зодиак	м.
зодчий	м.
золотистость	ж.
золотопромышленность	ж.
золотушный	прил. разг.
зоренька	ж. нар.-поэт.
зрачок	м.
зрелый	прил.
зритель	м.
зрячая	ж. разг.
зубочистка	ж.
зубрила	м. и ж. разг.
зубцы	мн.
зуд	м.
зюзя	м. и ж. разг.-сниж.
зябликов	прил.
ивовый	прил.
ивушка	ж. разг.
иглистый	прил.
иголка	ж.
игорный	прил.
играющая	ж. разг.
игрушка	ж.
идеализация	ж.
идеальный	прил.
идиотский	прил.
идиотство	ср. разг.
иезуитизм	м.
иезуитство	ср.
изабелла	ж.
избавление	ср.
избалованный	прил.
избиение	ср.
избитый	прил.
избрание	ср.
избранник	м.
избяной	прил.
изваяние	ср.
извержение	ср.
известь	ж.
извилистый	прил.
извлечение	ср.
изгнанница	ж.
изгнанный	прил.
изголовьице	ср. нар.-поэт.
изделие	ср.
издержка	ж.
излечение	ср.
изменник	м.
изменчивый	прил.
изморось	ж.
измызганный	прил. разг.-сниж.
измятый	прил.
изобретательность	ж.
израильский	прил.
изрезанный	прил.
изрубленный	прил.
изувер	м.
изумительный	прил.
изуродованный	прил.
изъявление	ср.
изысканность	ж.
иконка	ж. разг.
икс	м.
иллюминация	ж.
иллюстрация	ж.
иллюстрированный	прил.
имам	м.
именитый	прил.
именьишко	ср. разг.
императорский	прил.
импровизатор	м.
импровизированный	прил.
имущие	мн. разг.
инвалидный	прил.
индеец	м.
индивидуализм	м.
индивидуальность	ж.
индивидуум	м.
индикт	м.
индюшка	ж. разг.
инициалы	мн.
инквизиторский	прил.
инстинктивный	прил.
интеллигентность	ж.
интимность	ж.
интриганка	ж.
интрижка	ж. разг.
ипохондрия	ж.
ирод	м. разг.-сниж.
искание	ср.
искательница	ж.
исключительный	прил.
исковерканный	прил. разг.
искорка	ж. разг.
искупитель	м. разг.
искуситель	м.
искусница	ж. разг.
исповедание	ср.
исповедник	м.
испод	м. разг.-сниж.
исполнительница	ж.
исправление	ср.
исправность	ж.
испытанный	прил.
истерик	м. разг.
истеричка	ж. разг.
истопник	м.
истоптанный	прил. разг.
истощение	ср.
исхудалый	прил.
исцелитель	м.
исчисление	ср.
иудей	м.
иудейский	прил.
ишиас	м.
июльский	прил.
йота	ж.
кабаре	ср. нескл.
кабинетный	прил.
каверзник	м. разг.
каверзница	ж. разг.
кавказский	прил.
кавказцы	мн.
кавычка	ж.
кавычки	мн.
кадило	ср.
кадка	ж.
кадрильный	прил.
каждодневный	прил.
кажущийся	прил.
казанок	м. местн.
казарменный	прил.
казачество	ср.
каземат	м.
казимир	м.
каинов	прил.
кактус	м.
каламбурчик	м. разг.
калмык	м.
калым	м.
камаринский	м.
камеристка	ж.
камертон	м.
камзол	м.
камлот	м.
камыши	мн.
кандидат	м.
канифас	м.
каннибальство	ср.
канотье	ср. нескл.
канты	мн.
канцелярский	прил.
канчук	м. местн.
капеллан	м.
капельдинер	м.
капитанский	прил.
капо	м. нескл. разг.
капризник	м. разг.
капризница	ж. разг.
каптенармус	м.
караимка	ж.
караковый	прил.
карамболь	м.
карантин	м.
карась	м.
каратель	м.
караульная	ж. разг.
караульщик	м. разг.
карачаевский	прил.
карболка	ж. разг.
карбункул	м.
каре	ср. нескл.
каретник	м.
каретный	прил.
карикатура	ж.
кармелитка	ж.
картонка	ж. разг.
касательная	ж.
касаточка	ж. разг.
каска	ж.
кассия	ж.
катавасия	ж.
категория	ж.
каток	м.
католик	м.
каторжница	ж.
катышек	м. разг.
катышок	м. разг.
кафель	м.
кацавейка	ж.
кацап	м. разг.-сниж.
каюта	ж.
квакеры	мн.
квакушка	ж. нар.-поэт.
квинтэссенция	ж.
кепи	ср. нескл.
керосин	м.
кивок	м.
кизилевый	прил.
кикс	м.
кила	ж.
кимоно	ср. нескл.
киот	м.
кипа	ж.
кипарисовый	прил.
кипение	ср.
кирпичник	м.
кисейный	прил.
кисея	ж.
кисточка	ж. разг.
китайский	прил.
китаянка	ж.
клавиша	ж.
клака	ж.
кларнетист	м.
классики	мн.
классификация	ж.
классный	прил.
клейстер	м.
кленовый	прил.
клеппер	м.
клик	м.
клирошанин	м.
клоповник	м.
клумба	ж.
клык	м.
клыки	мн.
клюв	м.
клюква	ж.
клячонка	ж. разг.
книгоиздательство	ср.
книжник	м.
книжность	ж.
книжонка	ж. разг.
ковало	ср. местн.
кованый	прил.
ковыряние	ср.
кокон	м.
колба	ж.
колбасница	ж.
коленкор	м.
колесница	ж.
коловращение	ср.
колокольный	прил.
колымага	ж.
колыхание	ср.
колье	ср. нескл.
коляда	ж.
колядка	ж.
колясочка	ж. разг.
командировка	ж.
командирский	прил.
командующий	м.
комичность	ж.
коммерческий	прил.
комодик	м. разг.
компаньон	м.
компетентный	прил.
композитор	м.
компьютерный	прил.
конвой	м.
кондитер	м.
кондиция	ж.
конклав	м.
конкретный	прил.
конкурент	м.
конкурс	м.
коннозаводство	ср.
конокрадство	ср.
консерватизм	м.
конспект	м.
контрабанда	ж.
контрабандист	м.
контрагент	м.
контроверза	ж.
контур	м.
конфузливый	прил.
концертный	прил.
конченый	прил. разг.
конюшня	ж.
копеечный	прил.
копна	ж.
коптильный	прил.
копты	мн.
копун	м. разг.
копыто	ср.
копь	ж.
корабельный	прил.
кордебалет	м.
кордон	м.
коренья	мн.
кореш	м. разг.-сниж.
коридорчик	м. разг.
корица	ж.
кормило	ср.
королевский	прил.
королевство	ср.
корреспондент	м.
корсар	м.
корь	ж.
косенький	прил. разг.
косность	ж.
косноязычный	прил.
косоворотка	ж.
костистый	прил.
костлявый	прил.
костяной	прил.
котелок	м.
котельный	прил.
котище	м. разг.
коттедж	м.
кофейный	прил.
кофейня	ж.
кочерга	ж.
кочка	ж.
кочующий	прил.
кошачий	прил.
кошма	ж.
кошмарный	прил.
кощунство	ср.
краб	м.
краденое	ср. разг.
краденый	прил.
красивенький	прил. разг.
красноглазый	прил.
краснота	ж.
красотка	ж. разг.
краткий	прил.
краткость	ж.
крахмальный	прил.
кредитор	м.
креслице	ср. разг.
крести	мн. разг.
креститель	м.
крестница	ж.
крестьянка	ж.
кривляка	м. и ж. разг.
кривуля	ж. разг.-сниж.
кроватка	ж. разг.
кровообращение	ср.
кровопролитный	прил.
кровосмешение	ср.
кровоток	м.
кровяной	прил.
кроки	ср. нескл.
кролик	м.
кронпринц	м.
кропатель	м. разг.
крохотность	ж. разг.
кроше	ср. нескл.
крошеный	прил.
круглолицый	прил.
кругляк	м. разг.
крупа	ж.
крупник	м. местн.
крутизна	ж.
круча	ж.
кручина	ж. нар.-поэт.
кручинушка	ж. нар.-поэт.
крылатые	мн.
крылышко	ср. разг.
крынка	ж.
крючковатый	прил.
кряж	м.
кряхтение	ср.
кузнечный	прил.
кукольник	м. разг.
кукольный	прил.
кукушечка	ж. разг.
кулебяка	ж.
кулеш	м. местн.
кулики	мн.
кулич	м.
кунсткамера	ж.
купечество	ср.
купило	ср. разг.-сниж.
купля	ж.
купчая	ж. разг.
купчишка	м. разг.
куранты	мн.
курдюк	м.
курдючок	м. разг.
куриный	прил.
курник	м. местн.
курочек	м. разг.
курчонка	ж. разг.-сниж.
курьерша	ж. разг.
куряка	м. разг.-сниж.
кусака	м. и ж. разг.
кусточек	м. разг.
кухаркин	прил.
кухарочный	прил. разг.-сниж.
кухва	ж. местн.
кучерской	прил.
кушетка	ж.
куща	ж.
лавровые	мн.
ладанка	ж.
лаж	м.
лазеечка	ж. разг.
лаки	мн.
лакированный	прил.
лаковый	прил.
лакомство	ср.
ламы	мн.
ланита	ж. нар.-поэт.
ласточка	ж.
ласточкин	прил.
латыши	мн.
лгунья	ж.
лебеда	ж.
левада	ж.
левкас	м.
левкасный	прил.
левкой	м.
левретка	ж.
левша	м. и ж.
легендарный	прил.
легковерие	ср.
леденящий	прил.
ледок	м. разг.
лезгин	м.
лекарка	ж. местн.
лекарственный	прил.
лекция	ж.
лепесток	м.
лепка	ж.
лепта	ж.
лесочек	м. разг.
летуны	мн.
летучий	прил.
лечебный	прил.
лещик	м. разг.
лживость	ж.
лизин	м.
лизоблюд	м. разг.
ликтор	м.
ликующий	прил.
лилейные	мн.
лиловатый	прил.
лиман	м.
лимонад	м.
лимончик	м. разг.
лингвист	м.
липец	м. местн.
липкий	прил.
липовые	мн.
лирник	м.
лисий	прил.
листопад	м.
литейная	ж.
литературовед	м.
лития	ж.
литовцы	мн.
литограф	м.
литографированный	прил.
лихач	м. разг.
лиходей	м. разг.-сниж.
лихоманка	ж. местн.
лицеистик	м. разг.
лицемер	м.
лицемерный	прил.
логовище	ср.
лодочный	прил.
лодыжки	мн. разг.
ломание	ср.
лоскутик	м. разг.
лоскуточек	м. разг.
лососина	ж.
лось	м.
лото	ср. нескл.
лохмотник	м. разг.-сниж.
лошак	м.
лощина	ж.
луговой	прил.
луидор	м.
лунатизм	м.
лыковый	прил.
лысинка	ж. разг.
лысоватый	прил.
льгота	ж.
льдина	ж.
льдистый	прил.
любительский	прил.
любование	ср.
любознательность	ж.
любознательный	прил.
людоед	м.
люмбаго	ср. нескл.
лютеране	мн.
лютеранство	ср.
лядунка	ж.
ляжка	ж. разг.
мавзолей	м.
мавр	м.
магазинчик	м. разг.
магнит	м.
мажордом	м.
мазница	ж.
мазурик	м. разг.-сниж.
мазь	ж.
майорат	м.
майорский	прил.
макароны	мн.
макитра	ж. местн.
макрельный	прил.
малага	ж.
малахай	м.
малахит	м.
малахитовый	прил.
малинный	прил. разг.
маловер	м.
маловерие	ср.
малоземельный	прил.
малолетняя	ж. разг.
малорослый	прил.
малосведущий	прил.
малочисленность	ж.
мальчишеский	прил.
мальчугашка	м. разг.
маляр	м.
мамашин	прил. разг.
мамелюк	м.
мамин	прил.
мамонтов	прил.
мамура	ж.
манго	ср. нескл.
мандолинист	м.
маникюр	м.
манифест	м.
манна	ж.
манускрипт	м.
маразм	м.
марево	ср.
мармелад	м.
марс	м.
маршировка	ж.
масоны	мн.
мастерище	м. разг.
маститый	прил.
материалистка	ж. разг.
матерчатый	прил.
матрадура	ж.
матрац	м.
мачехин	прил.
машинист	м.
мебельный	прил.
медальончик	м. разг.
медвежьи	мн.
медуза	ж.
межа	ж.
междометие	ср.
меланхолик	м.
меланхолия	ж.
мелкобуржуазный	прил.
мелкота	ж. разг.
меловой	прил.
мелодичный	прил.
мелочишка	ж. разг.-сниж.
мельник	м.
мельники	мн.
мельников	прил. разг.
мельничиха	ж. разг.
мельхиоровый	прил.
меньшее	ср. разг.
меньшинство	ср.
меню	ср. нескл.
меринос	м.
мерлушечий	прил.
мерочка	ж. разг.
мертвецкий	прил.
месиво	ср. разг.
мессалина	ж.
местоимение	ср.
местонахождение	ср.
металлический	прил.
метаморфоз	м.
метаморфоза	ж.
метеор	м.
метод	м.
механика	ж.
меценат	м.
меценатка	ж. разг.
мешковатость	ж.
мешковатый	прил. разг.
мещанский	прил.
миазмы	мн.
мизантроп	м.
мизантропический	прил.
мизинный	прил. разг.
микитки	мн. разг.-сниж.
микст	м.
милашка	м. и ж. разг.
миледи	ж. нескл.
миллиончик	м. разг.
милушка	м. и ж. разг.-сниж.
миндаль	м.
миниатюра	ж.
мировая	ж. разг.
мировоззрение	ср.
мироздание	ср.
мироощущение	ср.
мирское	ср. разг.
мирт	м.
мисочка	ж. разг.
миссионерство	ср.
мистика	ж.
мистификатор	м.
митра	ж.
мифический	прил.
мифология	ж.
мишень	ж.
мишенька	м. разг.
мишурный	прил.
младенчик	м. разг.
млекопитающее	ср.
многозначительный	прил.
многоликий	прил.
многолюдство	ср.
многообразность	ж.
многоствольный	прил.
многосторонний	прил.
многострадальный	прил.
многоуважаемая	ж. разг.
могикане	мн.
могильный	прил.
могущественный	прил.
молекула	ж.
молодецкий	прил. разг.
молодняк	м. разг.
молодцеватый	прил.
молодчик	м. разг.-сниж.
молодчина	м. и ж. разг.
молотильный	прил.
молочный	прил.
молящий	прил.
моментальный	прил.
монетный	прил.
монотонный	прил.
моргун	м. разг.
мордаш	м.
мореход	м. разг.
морковный	прил.
моровой	прил.
морозище	м. разг.
морок	м. местн.
морошка	ж.
мортира	ж.
морфинистка	ж.
морщина	ж.
морщинистый	прил.
морщинка	ж. разг.
мотовка	ж. разг.
мохна	ж.
мохнатенький	прил. разг.
моховой	прил.
моча	ж.
мошеннический	прил.
мошка	ж.
мошкара	ж.
мошна	ж.
мститель	м.
мстительность	ж.
мудрила	м. и ж. разг.
мужественность	ж.
мужчинище	м. разг.
мундирный	прил.
мура	ж. разг.-сниж.
мусульманин	м.
муфточка	ж. разг.
мучительница	ж.
мучное	ср.
мучной	прил.
мхи	мн.
мшистый	прил.
мыльница	ж.
мыслительный	прил.
мыто	ср.
мычание	ср.
мышиный	прил.
мышонок	м.
мышца	ж.
мягкосердечный	прил.
мякоть	ж.
мяло	ср. местн.
мясное	ср. разг.
мятеж	м.
набег	м.
набережная	ж.
наболевший	прил.
наборная	ж. разг.
наборный	прил.
набросок	м.
набрюшник	м.
навоз	м.
навязчивость	ж.
нагар	м.
наглядный	прил.
нагноение	ср.
нагольный	прил.
нагорный	прил.
надгробный	прил.
надлом	м.
надоедала	м. и ж. разг.-сниж.
надоедание	ср.
надрывчатый	прил. разг.
надувательство	ср. разг.
надутость	ж.
наездница	ж.
назидательность	ж.
назойливость	ж.
накладка	ж.
накладной	прил.
наковальня	ж.
накопление	ср.
накрахмаленный	прил.
наливной	прил.
налим	м.
налог	м.
налой	м.
нанесение	ср.
нанковый	прил.
наносный	прил.
нападки	мн.
напилок	м. разг.
наполеондор	м.
направленность	ж.
напыщенность	ж.
нарвал	м.
наргиле	м. и ср. нескл.
народишка	м. разг.
народушко	м. разг.
нарочитый	прил.
нарушитель	м.
нарцисс	м.
насад	м.
насаждения	мн.
наследница	ж.
наслышка	ж. разг.-сниж.
насмешница	ж.
насып	м.
насыпь	ж.
натурфилософия	ж.
натурщица	ж.
натянутый	прил.
наушники	мн.
нахальность	ж.
находчивость	ж.
национализм	м.
начатое	ср. разг.
нашатырь	м.
наяда	ж.
неаккуратность	ж.
небесполезный	прил.
неблагонамеренность	ж.
неблагопристойность	ж.
неблагоразумие	ср.
неблагородство	ср.
небогатый	прил.
небрежение	ср.
небывальщина	ж. разг.
небытие	ср.
невежливость	ж.
невер	м. разг.
невзнос	м.
невиданный	прил.
невнятный	прил.
невозвратимый	прил.
невозвратное	ср. разг.
невозвратный	прил.
невоздержание	м.
невольничество	ср.
невообразимый	прил.
негаданное	ср. разг.
неглубокий	прил.
негритянский	прил.
негус	м.
недальний	прил.
недальновидный	прил.
недвижный	прил. разг.-сниж.
неделикатность	ж.
недеятельный	прил.
недовес	м.
недогадливость	ж.
недоеденный	прил.
недорогой	прил.
недосмотр	м.
недостаточный	прил.
недоуздок	м.
недружный	прил.
нежданный	прил.
нежелание	ср.
неженатый	прил.
неженка	м. и ж. разг.
незабвенное	ср.
незапамятный	прил.
незаслуженный	прил.
незлобный	прил.
незлой	прил.
неизбежность	ж.
неизлечимый	прил.
неизмеримое	ср.
неизъяснимый	прил.
неискренность	ж.
неисполнение	ср.
неисполнимость	ж.
неиссякаемый	прил.
неказистый	прил. разг.
неколебимость	ж.
некролог	м.
неладное	ср. разг.
нелады	мн. разг.
нелюбезность	ж.
нелюбезный	прил.
нелюбимый	прил.
нелюдимка	ж.
немазаный	прил.
немалый	прил.
немедленный	прил.
немилость	ж.
неминуемость	ж.
неминуемый	прил.
немногочисленный	прил.
немолчный	прил.
немота	ж.
немытый	прил.
ненасытный	прил.
ненатуральный	прил.
ненормальный	прил.
необдуманность	ж.
необдуманный	прил.
необитаемый	прил.
необразованность	ж.
необузданный	прил.
необъяснимость	ж.
необычный	прил.
неоднократный	прил.
неодобрение	ср.
неодолимый	прил.
неоперившийся	прил.
неоплатный	прил.
неопрятность	ж.
неосновательность	ж.
неосуществимость	ж.
неосязаемый	прил.
неотразимость	ж.
неохотница	ж. разг.
неписаный	прил.
непобедимость	ж.
непогрешимость	ж.
неподатливый	прил.
неподвластный	прил.
неподдельный	прил.
неподкупность	ж.
неподкупный	прил.
непоклонный	прил. разг.-сниж.
неполнота	ж.
неполный	прил.
непонятливость	ж.
непотребный	прил.
непочатый	прил.
неправильность	ж.
неправильный	прил.
непрактичность	ж.
непредвиденный	прил.
непреложность	ж.
непреоборимый	прил.
непрестанный	прил.
неприветливый	прил.
непривлекательность	ж.
неприглядный	прил.
неприготовленный	прил.
непризнанный	прил.
неприкосновенность	ж.
неприручимый	прил.
непристойность	ж.
неприступность	ж.
непродолжительный	прил.
непроезжий	прил.
непрошенный	прил.
непутное	ср.
непьяный	прил. разг.
неравный	прил.
неразвитость	ж.
неразрешимый	прил.
нераскаянный	прил.
нерассудительный	прил.
нервность	ж.
неряшливый	прил.
несбыточный	прил.
несвязанный	прил.
несимпатичный	прил.
нескладное	ср. разг.
нескрываемый	прил.
несловоохотливость	ж.
несложный	прил.
неслышность	ж.
неслышный	прил.
несмелый	прил.
несметный	прил.
несовершеннолетие	ср.
несоразмерность	ж.
несостоятельность	ж.
несуразное	ср. разг.
несытость	ж.
нетерпимость	ж.
нетронутый	прил.
нетто	прил. неизм.
неуверенный	прил.
неудавшийся	прил.
неуклонный	прил.
неукротимый	прил.
неуместный	прил.
неумолчный	прил.
неумытый	прил.
неумышленность	ж.
неумышленный	прил.
неурочный	прил.
неурядица	ж. разг.
неуспех	м.
неустановившийся	прил.
неустойка	ж.
неустройство	ср.
неусыпность	ж.
неусыпный	прил.
нехозяйственность	ж.
нецензурный	прил.
нечаянность	ж.
нечестивец	м.
нечистоплотный	прил.
нечисть	ж. разг.
неширокий	прил.
нижеследующее	ср.
низка	ж.
низкопробный	прил.
низшие	мн.
николаевский	прил.
ниспровержение	ср.
нищенка	ж.
нищенский	прил.
новенькое	ср. разг.
новизна	ж.
новобрачная	ж. разг.
новолуние	ср.
новь	ж.
номад	м.
норовистый	прил. разг.
носка	ж. разг.
нотариальный	прил.
нотариус	м.
ночка	ж. разг.
ночлежка	ж. разг.
ноябрьский	прил.
нужник	м. разг.-сниж.
нунций	м.
нутро	ср. разг.-сниж.
ныряльщик	м.
нытик	м. разг.
нюня	м. и ж. разг.
нянюшка	ж. разг.
оаз	м.
обвес	м.
обгон	м.
обдувала	м. и ж. разг.-сниж.
обдумывание	ср.
обедавший	м. разг.
обезображенный	прил.
обезумевшая	ж. разг.
обелиск	м.
оберег	м.
обескураженный	прил. разг.
обеспокоенный	прил.
обессиление	ср.
обещанный	прил.
обирала	м. и ж. разг.-сниж.
обитаемый	прил.
обличение	ср.
обличительный	прил.
обложка	ж.
облучок	м.
обмазка	ж.
ободранный	прил.
ободрительный	прил.
обожательница	ж. разг.
оборвыш	м. разг.
оборки	мн. местн.
оборотливость	ж. разг.
обострение	ср.
обоюдный	прил.
обработанный	прил.
обработка	ж.
образцовая	ж. разг.
образцовый	прил.
обременение	ср.
обритый	прил.
оброть	ж. местн.
обрывистый	прил.
обрывок	м.
обрюзгший	прил.
обскурант	м.
обстоятельный	прил.
обутый	прил.
обхват	м.
общежитие	ср.
общеизвестный	прил.
общипанный	прил. разг.
объединение	ср.
обязательный	прил.
овечий	прил.
овладение	ср.
овчинный	прил.
оглашенный	прил. разг.-сниж.
оглушающий	прил.
оглушение	ср.
огородник	м. разг.
ограбление	ср. разг.
ограниченность	ж.
одежонка	ж. разг.
одеревенелый	прил.
одеяльце	ср. разг.
одинаковость	ж.
одиннадцатилетний	прил.
одиссея	ж.
одичалость	ж.
одноглазая	ж. разг.
однодворок	м. местн.
однозвучный	прил.
однолетки	мн.
однородное	ср. разг.
одностволка	ж. разг.
одобрительный	прил.
одурелый	прил. разг.
одурманенный	прил.
одурь	ж. разг.
озабоченность	ж.
озерцо	ср.
озимь	ж.
ознаменование	ср.
океанский	прил.
околица	ж.
окровавленный	прил.
округлость	ж.
окружающий	прил.
окуляр	м.
окурок	м.
олень	м.
олимп	м.
омар	м.
омерзительность	ж.
омерзительный	прил.
опала	ж.
опекунский	прил.
оперный	прил.
опечаленный	прил.
описанный	прил.
оплеуха	ж. разг.
оплот	м.
опорки	мн.
оправа	ж.
оправдательный	прил.
опричники	мн.
опустелый	прил.
опустошение	ср.
опущенный	прил.
орание	ср. разг.
орарь	м.
ораторский	прил.
организатор	м.
организованный	прил.
органный	прил.
органчик	м.
оргия	ж.
орда	ж.
ординарец	м.
оркестрион	м.
орнамент	м.
оруженосец	м.
осада	ж.
осанистый	прил. разг.
освежение	ср.
осветительный	прил.
освободитель	м.
осетрина	ж.
осиротелый	прил.
оскал	м.
оскорбитель	м.
оскорбительный	прил.
ослышка	ж. разг.
осмысление	ср.
основательность	ж.
основательный	прил.
основоположник	м.
осока	ж.
остановка	ж.
остистый	прил.
остов	м.
остолбенелый	прил.
остолопство	ср. разг.
острастка	ж. разг.
остроконечный	прил.
осушение	ср.
осязательный	прил.
отбой	м.
отбор	м.
отбросы	мн.
отважность	ж.
отвар	м.
отверженный	прил.
отвод	м.
отводы	мн.
отгадывание	ср.
отговор	м.
отдохновение	ср.
отдыхающая	ж.
отдыхающий	м.
отживший	прил.
отзвучие	ср.
откашливание	ср.
откорм	м.
откуп	м.
откупоривание	ср.
отлог	м.
отлогий	прил.
отломок	м. разг.-сниж.
отлынивание	ср. разг.-сниж.
отмель	ж.
отомщение	ср.
отопление	ср.
оторопь	ж. разг.
отпадение	ср.
отпетый	прил. разг.
отпечаток	м.
отповедь	ж.
отрасль	ж.
отребье	ср.
отрез	м.
отрезок	м.
отрепья	мн.
отрешение	ср.
отрицатель	м.
отросток	м.
отрывочный	прил.
отрядный	прил.
отстранение	ср.
отступничество	ср.
отсырелый	прил.
отталкивающий	прил.
оттяжка	ж.
отшлифованный	прил.
отъявленный	прил.
отыскание	ср.
отяжеление	ср.
охлопья	мн.
охмеление	ср. разг.
охра	ж.
охранение	ср.
оцеп	м. местн.
очевидица	ж.
очередная	ж. разг.
ошалелый	прил. разг.-сниж.
ошибочка	ж. разг.
ощупь	ж.
пава	ж.
павильончик	м. разг.
павшая	ж.
пагуба	ж.
пакля	ж.
пакостник	м. разг.
пакостный	прил. разг.
палантин	м.
палисадник	м.
паломничество	ср.
палуба	ж.
паляница	ж. местн.
палящий	прил.
памфлет	м.
панегирик	м.
панталонцы	мн. разг.
пантеон	м.
папироса	ж.
папиросный	прил.
папиросочка	ж. разг.
папский	прил.
параграф	м.
парадоксалист	м.
паразитство	ср. разг.
паралитический	прил.
парапет	м.
парикмахер	м.
парикмахеров	прил. разг.-сниж.
парламентаризм	м.
парнище	м. разг.
парной	прил.
паровозик	м. разг.
парок	м. разг.
пароль	м.
парс	м.
парусиновый	прил.
пархатый	прил. разг.-сниж.
парчовый	прил.
паршивенький	прил. разг.
пасквильный	прил.
пасма	ж.
пасс	м.
пассажир	м.
пастбище	ср.
пасха	ж.
патера	ж.
патлатый	прил. разг.-сниж.
патриархальность	ж.
патриархальный	прил.
патриарший	прил.
патронташ	м.
пациентка	ж.
пачули	мн.
паштет	м.
паяц	м.
певучий	прил.
певческий	прил.
педагогический	прил.
пейсы	мн.
пек	м.
пекарь	м.
пелена	ж.
пелеринка	ж.
пенсия	ж.
пентюх	м. разг.-сниж.
пепельница	ж.
пепельный	прил.
первобытный	прил.
первоклассник	м.
перебег	м.
перебежчик	м.
перевязочный	прил.
перевязь	ж.
передок	м.
пережиток	м.
переимчивость	ж.
перекаты	мн.
перекличка	ж.
перекоп	м.
перекрытие	ср.
перелаз	м. разг.
перелив	м.
перепуг	м. разг.
перерез	м.
пересыльная	ж. разг.
пересып	м. разг.-сниж.
перетасовка	ж.
переутомление	ср.
перечисление	ср.
перешиб	м. разг.-сниж.
перистиль	м.
перрон	м.
персиковый	прил.
персы	мн.
перхота	ж. разг.
пескарь	м.
пессимист	м.
петит	м.
петуший	прил.
печатание	ср.
печерица	ж.
печной	прил.
пещер	м. местн.
пигмеи	мн.
пик	м.
пикантность	ж.
пикули	мн.
пилигрим	м.
пилигримство	ср.
пилка	ж. разг.
пингвин	м.
пион	м.
пирожник	м. разг.
писаный	прил. разг.
пискотня	ж. разг.
пистолетный	прил.
письмена	мн.
питание	ср.
питейное	ср. разг.
пищик	м.
плавающий	прил.
плагиатор	м.
пластырь	м.
плева	ж.
племенной	прил.
племянников	прил.
племянничек	м. разг.
пленительность	ж.
пленительный	прил.
пленница	ж.
плетение	ср.
плешина	ж.
пловец	м.
плодовитка	ж.
плодотворный	прил.
плоскодонка	ж.
плотина	ж.
плотников	прил.
плотоядные	мн.
плотоядный	прил.
плохонький	прил. разг.
плужок	м. разг.
плутишка	м. разг.
плутоватый	прил. разг.
плутовской	прил.
плывущий	прил.
плюгавый	прил. разг.
плясовая	ж. разг.
побегушка	м. и ж. разг.-сниж.
победительница	ж.
победоносец	м.
победоносный	прил.
побережный	прил.
побирушка	м. и ж. разг.-сниж.
побитый	прил.
повадливый	прил. разг.
повальный	прил.
повариха	ж.
поверенная	ж.
повествователь	м.
поветрие	ср. разг.
повинность	ж.
повязка	ж.
погибшая	ж.
поглядывание	ср.
погребальный	прил.
погребец	м.
погребной	прил.
погромыхивание	ср.
погружение	ср.
погудка	ж. местн.
подагра	ж.
подбородник	м. разг.
подвенечный	прил.
подверженный	прил.
подвесной	прил.
подвижной	прил.
подвижность	ж.
подвод	м.
подвода	ж.
подвоз	м.
подвои	мн.
подвязка	ж.
подгородный	прил.
подготовленный	прил.
подгулявший	м. разг.
подданный	м.
подделка	ж.
поддержка	ж.
подержанный	прил.
поджигатель	м.
поджога	ж. разг.-сниж.
подзатыльник	м.
подлинное	ср.
подлинность	ж.
подлинный	прил.
подлог	м.
подлюга	м. и ж. разг.-сниж.
подмастерье	м.
подмиг	м. разг.
подмигивающий	прил.
подмости	мн.
подмыв	м.
подносик	м. разг.
поднятие	ср.
подобающий	прил.
подобострастие	ср.
подобранный	прил.
подогретое	ср. разг.
подпасок	м.
подписание	ср.
подпол	м.
подпояска	ж. разг.
подпруга	ж.
подрост	м. разг.
подсвинок	м.
подсек	м.
подстриженный	прил.
подступ	м.
подтасовка	ж.
подтягивание	ср.
подымание	ср.
позапрошлый	прил.
поздравительный	прил.
познание	ср.
позолота	ж.
позолоченный	прил.
позументный	прил.
поилица	ж. нар.-поэт.
пойнтер	м.
показной	прил.
покат	м. разг.
покойничек	м. разг.
покоритель	м.
покосившийся	прил.
покровительница	ж.
покрышка	ж.
покупка	ж.
покус	м. разг.
полеводство	ср.
ползучий	прил. разг.
полинявший	прил.
полип	м.
полковничий	прил. разг.
полновесный	прил.
полномочие	ср.
полог	м.
полотнище	ср.
полотняный	прил.
полпути	м.
полуимпериал	м.
полукафтанье	ср.
полукровок	м. разг.
полукруглый	прил.
полунагой	прил.
полуобезьяна	ж.
полуоборот	м.
полупьяный	прил.
полусон	м.
полустанок	м.
полусфера	ж.
полутон	м.
полутона	мн.
полутьма	ж.
полушар	м.
полушерстяной	прил.
полюбовница	ж. разг.-сниж.
померанец	м.
померанцевые	мн.
помесь	ж.
помилование	ср.
поминание	ср.
помойный	прил.
помятый	прил.
понятливый	прил.
поощрение	ср.
поощритель	м.
попадья	ж. разг.
попас	м. местн.
поперечина	ж.
попечительница	ж.
поползновение	ср.
попона	ж.
попрыгунья	ж. разг.
популярный	прил.
попутчик	м.
попутчики	мн.
поредевший	прил.
породистый	прил.
пороша	ж.
порошинка	ж. разг.
портретик	м. разг.
португалец	м.
португальский	прил.
портфельчик	м. разг.
порция	ж.
посадка	ж.
посадник	м.
посвист	м.
посвящение	ср.
посинелый	прил. разг.
последователь	м.
последовательность	ж.
последующее	ср.
послеобеденный	прил.
послушливый	прил. разг.
посмешище	ср.
поспешный	прил.
посредничество	ср.
постепенный	прил.
постное	ср. разг.
постный	прил.
постоялец	м. разг.
постриг	м.
постскриптум	м.
постыдный	прил.
посягательство	ср.
потаскуха	ж. разг.-сниж.
потаскушка	ж. разг.-сниж.
потатчик	м. разг.
потатчица	ж. разг.
потерпевший	м. разг.
потирание	ср.
потребный	прил. разг.
потрясающий	прил.
потрясение	ср.
похититель	м.
похищенное	ср.
похоть	ж.
почин	м.
почитатель	м.
почтальон	м.
почтамт	м.
почтамтский	прил.
пошехонец	м.
поэтесса	ж.
поэтик	м. разг.
поярок	м.
поясок	м. разг.
праведная	ж.
правительственный	прил.
правка	ж.
правнуки	мн.
правовед	м.
правописание	ср.
празднество	ср.
праздничек	м. разг.
праздничность	ж.
праматерь	ж.
праотцы	мн.
прародители	мн.
пребойкий	прил.
пребольшой	прил.
пребольшущий	прил. разг.
превосходящий	прил.
превращение	ср.
превыспренний	прил.
преглупый	прил.
предательский	прил.
предвестник	м.
предвечерний	прил.
предлинный	прил.
предназначение	ср.
предок	м.
предотвращение	ср.
предполагаемый	прил.
предсказательница	ж.
предумышленный	прил.
предурной	прил. разг.
предшествовавший	прил.
предшествующий	прил.
предыдущее	ср.
преемница	ж.
преемничество	ср.
прежалкий	прил.
преждевременный	прил.
прежестокий	прил.
презанимательный	прил.
презлющий	прил. разг.
преинтересный	прил.
преисподняя	ж.
прекраснодушие	ср.
прелат	м.
прелюбодей	м.
пренеприятный	прил.
преобладание	ср.
преобразование	ср.
преотличный	прил.
преполезный	прил.
препорядочный	прил.
преприятный	прил.
пререкание	ср.
пресветлый	прил.
пресвятой	прил.
прескверный	прил.
преславный	прил.
пресладкий	прил.
пресмыкающийся	прил.
пресса	ж.
престарательный	прил.
престарелая	ж. разг.
престарый	прил.
престиж	м.
престранный	прил.
преужасный	прил.
преуморительный	прил. разг.
преупрямый	прил.
прехитрый	прил.
прибавление	ср.
прибавок	м. разг.
прибранный	прил.
привередливый	прил. разг.
привередница	ж. разг.
привкус	м.
привлекательное	ср.
привлекательность	ж.
приворот	м.
привратница	ж.
приглаженный	прил.
пригляд	м. разг.-сниж.
пригожий	прил.
придаточное	ср. разг.
придворная	ж. разг.
прижимистый	прил. разг.
призма	ж.
признанный	прил.
призываемый	м.
призывающий	прил.
прилизанный	прил. разг.
примадонна	ж.
применение	ср.
примерчик	м. разг.
приметный	прил.
примирительный	прил. разг.
примиряющий	прил.
принижение	ср.
приниженность	ж.
принцесса	ж.
приобретательница	ж.
приобщение	ср.
припадочек	м. разг.
припевание	ср.
припертень	м. местн.
приплюснутый	прил.
приподнятость	ж.
приподнятый	прил.
приращение	ср.
приречный	прил.
присвоение	ср.
приседание	ср.
присказка	ж.
прискорбный	прил.
прислужник	м.
приспешник	м.
приставной	прил.
пристойный	прил.
пристяжная	ж.
присяга	ж.
притязание	ср.
прихотливость	ж.
прихотливый	прил.
прицельный	прил.
причал	м.
причащение	ср.
причт	м.
причудливый	прил.
прищур	м.
приятельский	прил.
проблема	ж.
проблеск	м.
пробой	м.
проведение	ср.
провиант	м.
проводница	ж.
провождение	ср.
провокатор	м.
прогорелый	прил.
прогрессист	м.
продавщица	ж.
продел	м.
проделка	ж.
продолговатый	прил.
продув	м.
прожитое	ср.
прожорливость	ж.
прозаическое	ср.
прозрение	ср.
производство	ср.
производящий	прил.
произношение	ср.
происходившее	ср.
пройденное	ср.
проказливость	ж.
прокимен	м.
прокислый	прил. разг.
прокурорский	прил.
промедление	ср.
промельк	м.
проминка	ж.
промысел	м.
проникновение	ср.
проныра	м. и ж. разг.
пронырство	ср. разг.
пропажа	ж.
пропой	м. разг.-сниж.
пропуск	м.
пророческий	прил.
проруб	м.
просвет	м.
проседь	ж.
просительница	ж.
просительный	прил.
просо	ср.
простачка	ж. разг.
простейший	прил.
простец	м. разг.
простоватость	ж. разг.
простосердечие	ср.
простосердечный	прил.
простудный	прил.
простуженный	прил.
простушка	ж. разг.
просьбица	ж. разг.
просящая	ж.
противоестественный	прил.
протяжный	прил.
профанация	ж.
профессорский	прил.
профи	мн. нескл. разг.
проходящая	ж.
процветание	ср.
процедура	ж.
прочий	прил.
прочный	прил.
прошлогоднее	ср.
пружина	ж.
прусс	м.
пруссак	м.
прыгающие	мн.
прыгающий	прил.
прыгун	м.
прыщ	м.
прядь	ж.
пряменький	прил. разг.
прямота	ж.
прямоугольный	прил.
пряник	м.
пряности	мн.
псарный	прил.
пташечка	ж. разг.
птицелов	м.
птичница	ж.
публичный	прил.
пуганый	прил.
пугач	м.
пунктуация	ж.
пунцовый	прил.
пунька	ж. местн.
пупырышки	мн.
пурга	ж.
пурпурный	прил.
пускание	ср.
пустоголовая	ж. разг.
пустослов	м. разг.
пустынность	ж.
пустырь	м.
путеводительница	ж.
путешествующий	м.
пухленький	прил. разг.
пухлый	прил. разг.
пуховый	прил.
пучка	ж.
пушечный	прил.
пушистый	прил.
пчеловод	м.
пылающий	прил. разг.
пылинка	ж.
пытание	ср.
пытливость	ж. разг.
пьяноватый	прил. разг.
пюре	ср. нескл.
пядь	ж.
пятидневный	прил.
пятилетие	ср.
пятилетний	прил.
пятиэтажный	прил.
раввин	м.
равноденствие	ср.
равномерный	прил.
радиус	м.
радуга	ж.
разбойничество	ср.
разбойничий	прил.
разборчивость	ж.
разборчивый	прил.
разброд	м.
разброс	м.
разбросанный	прил.
развал	м.
развесистый	прил.
разветвление	ср.
разглашение	ср.
разгневанный	прил.
разграбление	ср.
разгром	м.
раздосадованный	прил.
раздробление	ср.
раздувание	ср.
разжига	ж. разг.-сниж.
разительный	прил.
разлитие	ср.
различный	прил.
размашистость	ж.
размашистый	прил.
разметка	ж.
размол	м.
размыкание	ср.
размытый	прил.
размягчение	ср.
разногласие	ср.
разноситель	м.
разобщение	ср.
разогрев	м.
разорванный	прил.
разоритель	м.
разрешитель	м. разг.
разрушитель	м.
разубранный	прил. разг.
разэтакий	прил. разг.
ракита	ж.
ракитовый	прил.
рамка	ж.
рандеву	ср. нескл.
раненая	ж.
ранет	м.
ранец	м.
раскачка	ж.
расклад	м.
раскладка	ж.
раскопки	мн.
раскрытие	ср.
распаренный	прил.
распашонка	ж.
распев	м.
расписание	ср.
расплющенный	прил.
располагающий	прил.
распорядительница	ж.
распорядительность	ж.
распределение	ср.
распроклятый	прил. разг.-сниж.
распря	ж.
распутница	ж. разг.
распухший	прил.
распьяный	прил. разг.
расселина	ж.
рассказик	м. разг.
расстил	м.
растение	ср.
растеря	м. и ж. разг.-сниж.
растерявшийся	прил.
растительность	ж.
растолкование	ср.
растоптанный	прил.
растравление	ср.
растрата	ж.
растущий	прил.
раут	м.
рациональный	прил.
рваный	прил.
рвань	ж.
рвота	ж.
реальный	прил.
ребус	м.
ребяческий	прил.
ребячий	прил. разг.
ревнивый	прил.
ревнитель	м.
ревностный	прил.
регламентация	ж.
регулы	мн.
редактирование	ср.
режим	м.
резервуар	м.
резец	м.
резиденция	ж.
резка	ж.
резонный	прил.
резюме	ср. нескл.
рей	м.
рейс	м.
ректификат	м.
рельс	м.
ремешок	м.
ренегат	м.
реноме	ср. нескл.
репейник	м.
репетитор	м.
реплика	ж.
рескрипт	м.
ресторанный	прил.
ретортный	прил.
реченька	ж. нар.-поэт.
ржавчина	ж.
ржавый	прил.
рикша	ж.
рисуночек	м. разг.
ритм	м.
рифмованный	прил.
ровесница	ж.
ровность	ж.
роговой	прил.
родильница	ж. местн.
родимые	мн. разг.
родственность	ж.
родственный	прил.
розанчик	м. разг.
роздых	м. разг.
розоватый	прил.
розыгрыш	м.
рокотание	ср.
россиянин	м.
россыпь	ж.
ростовщица	ж.
роток	м. разг.
рощица	ж. разг.
ртуть	ж.
рубака	м. разг.
рубашечка	ж. разг.
рубашечный	прил.
рубашонка	ж. разг.
рубеж	м.
рубило	ср.
рубленый	прил.
рубрика	ж.
рукавица	ж.
руководство	ср.
рукодел	м. разг.-сниж.
рукоделие	ср.
рукоять	ж. разг.
рулет	м.
румба	ж.
румын	м.
рупор	м.
рутина	ж.
ручник	м. местн.
рцы	ср. нескл.
рыбачий	прил.
рыбное	ср. разг.
рыдающий	прил.
рычаг	м.
рычание	ср.
рябиновка	ж.
рядно	ср.
салазки	мн.
сальто	ср. нескл.
сальце	ср. разг.
самобытность	ж.
самоваришко	м. разг.
самовольный	прил.
самодеятельность	ж.
самодовольство	ср.
самодурка	ж. разг.
самозабвение	ср.
самолюбец	м. разг.
самомнительный	прил. разг.-сниж.
самонадеянность	ж.
самообладание	ср.
самообман	м.
самообольщение	ср.
самоотвержение	ср.
самопал	м.
самопрялка	ж.
самоуважение	ср.
самоумаление	ср.
самоуничижение	ср.
самохвальство	ср. разг.
сандвич	м.
санный	прил.
сарайчик	м. разг.
саранча	ж.
сарацинский	прил.
сарказм	м.
саркастический	прил.
саркастичность	ж.
сарматский	прил.
сатирик	м.
сатирический	прил.
сахарный	прил.
сбег	м. разг.-сниж.
сбивчивость	ж.
сборище	ср. разг.
сборчатый	прил.
сброд	м.
сбыв	м. разг.-сниж.
сварливый	прил.
свеженький	прил. разг.
сверхштатный	прил.
сверхъестественный	прил.
свес	м.
светленький	прил. разг.
светскость	ж.
светящийся	прил.
свечной	прил.
свидетельница	ж.
свидетельский	прил.
свиной	прил.
свинский	прил. разг.
свинушка	ж.
свирепость	ж.
свистулька	ж. разг.
свистун	м. разг.
свистящий	прил.
сводник	м.
своевольная	ж.
свойственник	м.
связа	ж. местн.
связующий	прил.
святотатец	м.
святоша	м. и ж.
священство	ср.
сговорчивость	ж.
сговорчивый	прил.
сдавленный	прил.
сеанс	м.
себялюбец	м.
северные	мн. разг.
североамериканец	м.
северянин	м.
седина	ж.
седобородый	прил.
седовласый	прил.
сеид	м.
сейм	м.
сейф	м.
секира	ж.
секретный	прил.
сектантка	ж.
семейка	ж. разг.
семейная	ж. разг.
семейственный	прил.
семимесячный	прил.
сенокос	м.
сераль	м.
сервированный	прил.
сердечишко	ср. разг.
сердцебиение	ср.
сердцеведение	ср.
серный	прил.
сероглазая	ж. разг.
серпик	м. разг.
сетка	ж.
сетования	мн.
сеченый	прил.
сжатость	ж.
сибарит	м.
сивая	ж. разг.
силач	м.
символический	прил.
симка	ж. местн.
симптом	м.
синенькие	мн. разг.
синенький	прил. разг.
синклит	м.
синод	м.
синтаксис	м.
синтез	м.
синьора	ж.
сирийский	прил.
сиротинушка	м. и ж. нар.-поэт.
сиротский	прил.
сирые	мн.
ситец	м.
сказительница	ж.
скалдырник	м. разг.-сниж.
скалдырничество	ср. разг.-сниж.
скалистый	прил.
скамеечка	ж. разг.
скамья	ж.
скандалист	м.
скаредность	ж. разг.
скаредный	прил. разг.
сквернослов	м.
скворечница	ж.
скип	м.
скирд	м.
скиталец	м.
скитальчество	ср.
скитский	прил.
скифы	мн.
сковорода	ж.
скорбный	прил.
скорлупка	ж. разг.
скоромное	ср.
скороспелый	прил.
скороходь	ж. разг.-сниж.
скорпион	м.
скотинка	ж. разг.
скрежет	м.
скреп	м. разг.
скромненький	прил. разг.
скромник	м. разг.
скрытый	прил.
скучища	ж. разг.
слабеющий	прил.
слабительное	ср.
слабогрудый	прил. разг.
слабосильная	ж. разг.
слабоумие	ср. разг.
слабоумный	прил. разг.
славянский	прил.
сладенький	прил. разг.
слаженный	прил.
сластёны	мн. местн.
сласти	мн. разг.
сластолюбец	м.
сластолюбивый	прил.
сластолюбие	ср.
слащавый	прил.
следок	м. разг.
слежавшийся	прил.
слепящий	прил.
слесарский	прил.
слесарь	м.
сливянка	ж.
слободской	прил.
словесница	ж.
словесный	прил.
словоохотливый	прил.
сложность	ж.
слуховой	прил.
слюда	ж.
слюнтяй	м. разг.
смак	м. разг.
смердящий	прил.
смертоубийство	ср. разг.
смерч	м.
смешанность	ж.
смирна	ж.
смирненький	прил. разг.
смородинный	прил.
смотрение	ср.
смотрины	мн.
смуглость	ж.
смуглота	ж.
смута	ж.
смушка	ж.
смятенный	прил.
снежочек	м. разг.
снисходительный	прил.
снотворное	ср.
снохачество	ср. разг.-сниж.
сношение	ср.
соболий	прил.
соборование	ср.
собранное	ср.
собрат	м.
собутыльник	м. разг.
совершеннолетняя	ж.
совок	м.
совокупление	ср.
современность	ж.
соглядатай	м.
содержатель	м.
создательница	ж.
созерцательный	прил.
сокровенный	прил.
солдатский	прил.
солдафонство	ср. разг.
соление	ср.
соленья	мн.
солея	ж.
солитер	м.
соловушка	м. нар.-поэт.
соловьиный	прил.
соломенный	прил.
солонина	ж.
сонливость	ж.
сообразный	прил.
сопатый	прил. местн.
сопилка	ж.
соприкосновение	ср.
соразмерный	прил.
соседство	ср.
сосна	ж.
составление	ср.
состязание	ср.
сосунок	м. разг.
сотенка	ж. разг.
сотерн	м.
сотников	прил. разг.
сотоварищ	м.
сотрудница	ж.
сотский	м.
сочетания	мн.
сочувственный	прил.
спад	м.
спаленка	ж. разг.
спасательный	прил.
спасительница	ж.
спасительность	ж.
спелый	прил.
спец	м. разг.
специальность	ж.
специальный	прил.
спираль	ж.
спирит	м.
спиритизм	м.
спитой	прил. разг.
спица	ж.
спич	м.
спожинки	мн. местн.
спорщик	м.
спорщица	ж.
справочник	м.
спусковой	прил.
спящая	ж.
сравнимый	прил.
срамница	ж. разг.-сниж.
средневековый	прил.
срез	м.
становище	ср.
стариковский	прил.
старичонка	м. разг.
старомодный	прил.
старостин	прил.
старостиха	ж. разг.
старшенькая	ж. разг.
статистик	м.
статут	м.
стелька	ж.
степенство	ср. разг.
стеснительность	ж.
стетоскоп	м.
стилист	м.
стипендия	ж.
стихарь	м.
стог	м.
стоимость	ж.
сторожкий	прил. разг.-сниж.
сторонний	прил.
стояние	ср.
стоячий	прил.
странница	ж.
странствование	ср.
страстишка	ж. разг.
страстность	ж.
страус	м.
страховка	ж. разг.
страшенный	прил. разг.
страшила	м. и ж. разг.
стрелок	м.
стремительный	прил.
стрижка	ж.
стройненький	прил. разг.
строптивая	ж.
струистый	прил.
струйка	ж. разг.
стряпня	ж. разг.
стряпухин	прил. разг.
студентик	м. разг.
студень	м.
стукотня	ж. разг.
ступка	ж. разг.
ступня	ж.
субботний	прил.
судопроизводство	ср.
судорожный	прил.
судоходный	прил.
судьбина	ж. нар.-поэт.
суеверный	прил.
суженый	м. нар.-поэт.
суконце	м. разг.
сумбурный	прил.
сумочка	ж. разг.
сургучик	м. разг.
суровец	м. местн.
сустав	м.
сутолока	ж.
суточные	мн.
сухожилие	ср.
сухопутный	прил.
сучий	прил.
сушение	ср.
сушки	мн.
существующее	ср.
сфера	ж.
схема	ж.
сценический	прил.
съедение	ср.
съедобное	ср.
сыворотка	ж.
сыноубийца	м. и ж.
сырники	мн.
сырный	прил.
сытость	ж.
сюртучок	м. разг.
табачище	м. разг.
табачок	м. разг.
таблица	ж.
табльдот	м.
табу	ср. нескл.
табурет	м.
тавро	ср.
танагра	ж.
танцовщица	ж.
тарантасик	м. разг.
таратайка	ж.
тарахтение	ср. разг.
тартюфство	м.
таска	ж. разг.-сниж.
татарчонок	м. разг.
театрал	м.
театральный	прил.
теин	м.
телеграфный	прил.
тельца	мн.
темляк	м.
темь	ж. разг.
тенистый	прил.
теннис	м.
тент	м.
теоретик	м.
терзания	мн.
термометр	м.
терпеливый	прил.
тест	м.
тетрадочка	ж. разг.
техника	ж.
технолог	м.
типичность	ж.
типичный	прил.
тирада	ж.
титаны	мн.
титло	ср.
тихенький	прил. разг.
тихонький	прил. разг.
тишь	ж. разг.
товарец	м. разг.
тога	ж.
толокно	ср.
толстогубый	прил.
томительный	прил.
томность	ж.
томпаковый	прил.
топаз	м.
топливо	ср.
топь	ж.
торбан	м.
торгаш	м. разг.
торговец	м. разг.
торк	м.
торс	м.
тоскующий	прил.
точило	ср.
точильный	прил.
тошнота	ж.
травянистый	прил.
трагичность	ж.
траектория	ж.
трактиришко	м. разг.
трамонтана	ж.
транспарант	м.
трапеза	ж.
трапезник	м.
трезвая	ж.
треклятый	прил. разг.-сниж.
трен	м.
трепетание	ср.
трепетный	прил.
тривиальность	ж.
тривиальный	прил.
трилистник	м.
триумф	м.
трихина	ж.
трицепс	м.
трогательный	прил.
троглодит	м.
тролль	м.
тромбон	м.
тронутая	ж. разг.
тропарь	м.
трос	м.
тросточка	ж. разг.
трубадур	м.
трубочист	м.
трудолюб	м. разг.
труженица	ж.
трупик	м. разг.
трусливая	ж.
трусливость	ж.
тряпичный	прил.
тряпочка	ж. разг.
трясина	ж.
тряска	ж.
трясучая	ж. разг.-сниж.
туарег	м.
тулья	ж.
тупица	м. и ж. разг.
тупоносый	прил.
тупость	ж.
турбинная	ж. разг.
туриный	прил.
турнюра	ж.
тушь	ж.
тщательный	прил.
тщедушный	прил.
тысячеголосый	прил.
тэк	м.
тюлевый	прил.
тюль	м.
тюльпан	м.
тюркский	прил.
тягота	ж. разг.
тяготение	ср.
тяжеловесный	прил.
уважаемая	ж. разг.
увешанный	прил.
увлекательный	прил.
увядший	прил.
угадчик	м. разг.
угловатости	мн. разг.
угнетатель	м.
угодливый	прил.
угодник	м.
угодное	ср.
угодье	ср.
уголовщина	ж. разг.
угрева	ж. местн.
угреватый	прил.
угрожающий	прил.
угры	мн.
удав	м.
удаль	ж.
удальство	ср.
ударение	ср.
удачливость	ж.
удержание	ср.
удилище	ср.
удовлетворительность	ж.
удушающий	прил.
уезжающий	м.
узда	ж.
узелочек	м. разг.
узкоглазый	прил.
узорный	прил. разг.
уклонение	ср.
уклончивость	ж.
укол	м.
украденный	прил.
украинцы	мн.
укус	м.
уланский	прил.
уличка	ж. разг.
ультиматум	м.
ультрамонтан	м.
уменьшение	ср.
умирающая	ж.
умолот	м.
умопомрачительный	прил. разг.
умор	м. местн.
умственный	прил.
умывальник	м.
униженная	ж.
уничижение	ср.
уничтожающий	прил.
упоительный	прил.
упорность	ж.
упрекающий	прил.
упрямица	ж. разг.
уральский	прил.
урна	ж.
уродливый	прил.
уродство	ср.
уроженка	ж.
усастый	прил. разг.
усатенький	прил. разг.
усвоение	ср.
усердная	ж.
усиление	ср.
усопшая	ж.
успешность	ж.
успешный	прил.
успокоительный	прил.
установление	ср.
устерс	м.
устойчивость	ж.
устойчивый	прил.
уступка	ж.
уступок	м. разг.
усыпляющий	прил.
утешительница	ж.
утиный	прил.
утоление	ср.
утопающая	ж.
утопленник	м.
утрата	ж.
утрировка	ж. разг.
ухаб	м.
ухожье	ср. местн.
ученица	ж.
учительница	ж.
ушастый	прил. разг.
ушица	ж. разг.
ушу	ср. нескл.
уютный	прил.
фабула	ж.
фавор	м.
фазис	м.
фактик	м. разг.
фанданго	ср. нескл.
фантази	прил. неизм.
фараонов	прил.
фасончик	м. разг.
фатальный	прил.
фаэтоны	мн.
фельдъегерь	м.
феодальный	прил.
фиалковый	прил.
фиаско	ср. нескл.
фиг	м.
фиглярство	ср.
фижмы	мн.
физиология	ж.
физиономист	м.
филантропия	ж.
философствование	ср. разг.
фильм	м.
финифтяный	прил.
фискал	м.
фланель	ж.
флегматик	м.
флот	м.
флотилия	ж.
фляжка	ж.
фонограф	м.
фонтанчик	м. разг.
форейтор	м.
форель	ж.
формуляр	м.
формулярный	прил.
фото	ср. нескл. разг.
фрагмент	м.
франки	мн.
франтиха	ж. разг.
фрачишка	м. разг.
фрейлейн	ж. нескл.
фрикасе	ср. нескл.
фру	ж. нескл.
фруктовый	прил.
хабар	ж. разг.-сниж.
хабара	ж. разг.-сниж.
хала	ж.
халатность	ж.
хан	м.
хаотический	прил.
хапуга	м. и ж. разг.-сниж.
характеристика	ж.
хаханьки	мн. разг.
хвалебный	прил.
хвастливость	ж.
хвастунишка	м. и ж. разг.
хворость	ж. разг.-сниж.
хвостище	м. разг.
хер	м.
химик	м.
хитроумный	прил.
хихикание	ср. разг.
хищник	м.
хищничество	ср.
хлебопашество	ср.
хлебосольство	ср.
хлопотливость	ж.
хлопотунья	ж. разг.
хлыстик	м. разг.
хмельное	ср. разг.
хныкала	м. и ж. разг.
ходатайство	ср.
хозяйственный	прил.
холмик	м. разг.
холстик	м. разг.
хоровод	м.
хотение	ср.
хохлацкий	прил. разг.-сниж.
хохотливый	прил. разг.
храмовой	прил.
хрия	ж.
хроника	ж.
хронометр	м.
хрычовка	ж. разг.-сниж.
художественность	ж.
царедворец	м.
царский	прил.
царственность	ж.
цветистый	прил. разг.
целебный	прил.
целина	ж.
цемент	м.
цензор	м.
ценитель	м.
ценности	мн.
централизация	ж.
цеп	м.
цербер	м.
церемониальный	прил.
церемониймейстер	м.
цибуля	ж. местн.
цивилизованный	прил.
цикл	м.
циклопический	прил.
цинический	прил.
циркуль	м.
цитадель	ж.
цукаты	мн.
цыганщина	ж. разг.
чаишко	м. разг.
чал	м.
чалая	ж.
чапыжник	м. местн.
чародейство	ср.
чары	мн.
часовенка	ж. разг.
часовщик	м.
часослов	м.
частицы	мн.
чаус	м.
чахленький	прил. разг.
чек	м.
челобитная	ж.
человеколюбец	м.
человечность	ж.
челядь	ж.
чемпион	м.
чепан	м.
червоточина	ж.
черевички	мн. разг.
чересседельник	м.
черешневый	прил.
черкешенка	ж.
черноватый	прил.
чернолесье	ср.
черноногая	ж.
черноокая	ж.
чертовка	ж.
чертополох	м.
чертяка	м. разг.-сниж.
чеснок	м.
чесучовый	прил.
четверня	ж. разг.
четверостишие	ср.
четвертная	ж. разг.
четырнадцатилетний	прил.
чехи	мн.
чехольчик	м. разг.
чеченец	м.
чешуя	ж.
чинар	м.
чиновничек	м. разг.
чинопочитание	ср.
чистилище	ср.
чистоплотный	прил.
чищеный	прил.
чопорность	ж.
чуваши	мн.
чувственный	прил.
чувяк	м.
чудачество	ср.
чудовищный	прил.
чуждый	прил.
чулочек	м. разг.
чуня	ж.
чуприна	ж. местн.
чуткость	ж.
шаловливость	ж.
шаманский	прил.
шанс	м.
шантажист	м.
шапито	ср. нескл.
шапочка	ж. разг.
шариат	м.
шатенка	ж.
шафер	м.
шахматный	прил.
шашлык	м.
шашни	мн. разг.
швейцарка	ж.
шевалье	м. нескл.
шелковистый	прил.
шелудивая	ж. разг.
шельмовка	ж. разг.
шен	м.
шестиугольник	м.
шестнадцатилетний	прил.
шеф	м.
шинелишка	ж. разг.
ширина	ж.
широколицый	прил.
широты	мн.
ширь	ж.
шкафик	м. разг.
школьница	ж.
школьный	прил.
шлюп	м.
шляпник	м. разг.
шляхетство	ср.
шнапс	м. разг.
шовинизм	м.
шовинист	м.
шотландский	прил.
шпионка	ж.
шпиц	м.
шпор	м.
шпора	ж.
шрапнель	ж.
штандарт	м.
штатское	ср.
штаты	мн. разг.
штиблеты	мн.
штосс	м.
штофик	м. разг.
штрипка	ж.
штукенция	ж. разг.
штунда	ж.
штурм	м.
шулерство	ср.
шустрый	прил. разг.
шутливость	ж.
шуточное	ср.
щеколда	ж.
щекотливость	ж.
щекочущий	прил.
щепной	прил.
щупленький	прил. разг.
щуплый	прил.
эдемский	прил.
экземплярец	м. разг.
экземплярчик	м. разг.
экономка	ж.
экспансивный	прил.
эксплуататор	м.
экспромт	м.
эллин	м.
эллины	мн.
эльдорадо	ср. нескл.
эмалированный	прил.
эмбрион	м.
энергетика	ж.
энергичный	прил.
эпидемия	ж.
эпилепсия	ж.
эпилептический	прил.
эпитафия	ж.
эпопея	ж.
эскапада	ж.
эскиз	м.
эспаньолка	ж.
эстет	м.
эстетика	ж.
этажерка	ж.
этика	ж.
этнографический	прил.
этюд	м.
эфемерность	ж.
эфироман	м.
южане	мн.
юморист	м.
юношество	ср.
юридический	прил.
юродство	ср.
юстиция	ж.
юфть	ж.
ябедничество	ср. разг.
явор	м.
язвительность	ж.
языческий	прил.
язычество	ср.
ялик	м.
ямб	м.
ямочки	мн. разг.
янтарный	прил.
янтарь	м.
ярлычок	м. разг.
яростный	прил.
ярочка	ж. разг.
ясень	м.
яхонт	м.
ячейка	ж.
